MeasID,YEAR,CO,JUR,CNTYNAME,DATE,PLACE,CSD,MEASTYPE,LTR,BALQUEST,Orig_TYPE,RECTYPE,RECTYPENAME,Orig_TOPIC,RECTOPIC,RECTOPNAME,YES,NO,TOTAL,PERCENT,REQ,OUTCOME,PASSFAIL,Multi_CO,Multi_MeasID,YES_sum,NO_sum,Total_sum,Percent_sum,Outcome_sum,passfail_sum,typerec,topicrec
199600001,1996,52,1,TEHAMA,1996-02-06,TEHAMA,0,R,Dist. 2,"Recall of Supervisor, District Two - Shirley M. Marelli.",50,50,Recall,48,46,Governance: Recall,8265,4144,12409,0.6660488355226045,M,1,Pass,0,199600001,8265,4144,12409,0.6660488355226045,1,Pass,50,40
199600002,1996,52,1,TEHAMA,1996-02-06,TEHAMA,0,R,Dist. 4,"Recall of Supervisor, District Four - Joann Landingham.",50,50,Recall,48,46,Governance: Recall,7714,4589,12303,0.6270015443387792,M,1,Pass,0,199600002,7714,4589,12303,0.6270015443387792,1,Pass,50,40
199600003,1996,52,1,TEHAMA,1996-02-06,TEHAMA,0,R,Dist. 5,"Recall of Supervisor, District Five - Kathleen Rowen.",50,50,Recall,48,46,Governance: Recall,8422,3869,12291,0.6852168253193394,M,1,Pass,0,199600003,8422,3869,12291,0.6852168253193394,1,Pass,50,40
199600004,1996,37,3,SAN DIEGO,1996-02-27,SWEETWATER UNION HIGH SCHOOL DISTRICT-SEAT 2,0,R,2,Shall STEVE HOGAN be recalled (removed) from Seat No. 2 of the Governing Board for Sweetwater Union High School District?,50,50,Recall,46,13,Education: Recall,7195,8587,15782,0.4558991255861108,M,2,Fail,0,199600004,7195,8587,15782,0.45589912558611073,2,Fail,50,10
199600005,1996,37,3,SAN DIEGO,1996-02-27,SWEETWATER UNION HIGH SCHOOL DISTRICT-SEAT 3,0,R,3,Shall GREG R. SANDOVAL be recalled (removed) from Seat No. 3 of the Governing Board for Sweetwater Union High School District?,50,50,Recall,46,13,Education: Recall,6805,9588,16393,0.41511620813761974,M,2,Fail,0,199600005,6805,9588,16393,0.41511620813761974,2,Fail,50,10
199600006,1996,37,3,SAN DIEGO,1996-02-27,SWEETWATER UNION HIGH SCHOOL DISTRICT-SEAT 4,0,R,4,Shall ROBERT GRIEGO be recalled (removed) from Seat No. 4 of the Governing Board for Sweetwater Union High School District?,50,50,Recall,46,13,Education: Recall,7229,9303,16532,0.4372731671909025,M,2,Fail,0,199600006,7229,9303,16532,0.4372731671909025,2,Fail,50,10
199600007,1996,2,1,ALPINE,1996-03-26,ALPINE,0,R,,"Shall WARREN JANG be recalled (removed) from the office of Supervisor, 4th District of Alpine County?",50,50,Recall,48,46,Governance: Recall,114,38,152,0.75,M,1,Pass,0,199600007,114,38,152,0.75,1,Pass,50,40
199600008,1996,4,1,BUTTE,1996-03-26,BUTTE,0,M,A,"In order to maintain the current level of County services, including fire protection, law enforcement, criminal prosecution and library services, shall the Utility User Tax levied in the unincorporated area of Butte County by Ordinance Number 3229 be aproved, thereby continuing the tax at its current rate until the year 20, at which time the tax shall expire?",5,5,Utility Tax,100,112,Revenues: Tax Creation/Incr./Contin.,16906,14170,31076,0.544021109537907,M,1,Pass,0,199600008,16906,14170,31076,0.544021109537907,1,Pass,1,110
199600009,1996,5,1,CALAVERAS,1996-03-26,CALAVERAS,0,M,A,"Shall the ""Calaveras Municipal Utility District"" be created and established as a Countywide district with the intent to seek approval to provide electric service?",70,70,Ordinance,43,43,Governance: Organization,3648,1086,4734,0.770595690747782,M,1,Pass,0,199600009,3648,1086,4734,0.770595690747782,1,Pass,70,40
199600010,1996,5,1,CALAVERAS,1996-03-26,CALAVERAS,0,M,B,"Shall the County-wide Transient Occupancy Tax be raised from six percent (6%) to eight percent (8%), with an amount equal to thirty-one percent (31%) of the total Transient Occupancy Tax received by the County to be used to promote tourism in the County?",2,2,Business Tax,200,201,Other: Promotion of Tourism,3964,8252,12216,0.3244924688932547,T,2,FailT,0,199600010,3964,8252,12216,0.3244924688932547,2,FailT,1,200
199600011,1996,11,1,GLENN,1996-03-26,GLENN,0,M,C,"Shall the Board of Supervisors establish the consolidated office of Director of Finance, to perform the duties of Auditor-Controller and Treasurer-Tax Collector for Glenn County?",70,70,Ordinance,42,42,Governance: Personnel/Labor Relations,3505,2087,5592,0.626788268955651,M,1,Pass,0,199600011,3505,2087,5592,0.626788268955651,1,Pass,70,40
199600012,1996,11,1,GLENN,1996-03-26,GLENN,0,M,D,Shall a unified school district be formed between Orland Joint Union High School and the Orland Joint Union School District excluding the school districts of Lake and Plaza?,70,70,Ordinance,12,12,Education: Districts,1560,1021,2581,0.6044168926772568,M,1,Pass,0,199600012,1560,1021,2581,0.6044168926772568,1,Pass,70,10
199600013,1996,17,1,LAKE,1996-03-26,LAKE,0,M,S,We the people of the County of Lake support the sitting of a State Prison in the County of Lake.,30,30,Advisory,31,31,Safety: Jails/Courts,7952,8887,16839,0.4722370687095433,M,2,Fail,0,199600013,7952,8887,16839,0.4722370687095433,2,Fail,30,30
199600014,1996,22,1,MARIPOSA,1996-03-26,MARIPOSA,0,M,A,"Shall the following ordinance (measure) be adopted?  ""The Office of the Mariposa County Constable is hereby abolished.  The duties of the Constable shall be performed by the Mariposa County Sheriff's Office commencing January 1, 1997.""  This ordinance shall become operative and effective at 12:01 a.m. on January 1, 1997 if approved by a majority vote of the electorate in the March 1996 Primary Election.",70,70,Ordinance,32,32,Safety: Police,3779,1700,5479,0.6897244022631869,M,1,Pass,0,199600014,3779,1700,5479,0.6897244022631868,1,Pass,70,30
199600015,1996,22,1,MARIPOSA,1996-03-26,MARIPOSA,0,M,B,"Shall the following ordinance (measure) be adopted?  ""For the privilege of occupancy in any hotel, each transient is subject to and shall pay a tax in the amount of ten percent (10%) of the rent charged by the operator.  Such tax constitutes a debt owed by the transient to the county which is extinguished old by payment to the operator or to the county.  The transient shall pay the tax to the operator of the hotel at the time the rent is paid.  If the rent is paid in installments, a proportionate share of the tax shall be paid with each installment.  The unpaid tax shall be due upon the transient's ceasing to occupy space in the hotel.  If for any reason the tax due is not aid to the operator of the hotel, the tax collector may require that such tax be paid directly to the tax collector.""  This ordinance shall become effective March 27, 1996, if approved by a majority of the voters in the March 1996 Primary Election.",2,2,Business Tax,100,112,Revenues: Tax Creation/Incr./Contin.,3514,1975,5489,0.6401894698487884,M,1,Pass,0,199600015,3514,1975,5489,0.6401894698487884,1,Pass,1,110
199600016,1996,23,1,MENDOCINO,1996-03-26,MENDOCINO,0,M,C,Shall Ordinance No. 3919 proposing an additional countrywide transactions and use tax of one-quarter of one percent (.25%) be adopted in the incorporated and unincorporated territory of Mendocino County?,4,4,Sales Tax,200,110,Revenues,8309,13378,21687,0.38313275234011157,T,2,FailT,0,199600016,8309,13378,21687,0.38313275234011157,2,FailT,1,110
199600017,1996,25,1,MODOC,1996-03-26,MODOC,0,M,A,"Shall the Legislature place on the statewide ballot a proposed amendment to the California Constitution to give local government jurisdictions the legal authority to (a) decline to implement a program mandated by the State or Federal government without the full funding necessary to perform the mandated service, or (b) discontinue a program mandated by the State or Federal government when all funds provided by the State or Federal government for such a mandate have been expended?",30,30,Advisory,45,45,Governance: Political Reform/Term Limits,2606,814,3420,0.762,M,1,Pass,0,199600017,2606,814,3420,0.7619883040935672,1,Pass,30,40
199600018,1996,28,1,NAPA,1996-03-26,NAPA,0,M,W,Should Napa County Ordinance No. 96-1 (Controlled Growth Initiative) be adopted?,70,70,Ordinance,21,21,Land Use: Growth Cap/Boundary,6053,30702,36755,0.16468507686029113,M,2,Fail,0,199600018,6053,30702,36755,0.16468507686029113,2,Fail,70,20
199600019,1996,28,1,NAPA,1996-03-26,NAPA,0,M,X,Should Napa County Ordinance No. 96-2 (Suscol Creek Balanced Planning Initiative) be adopted?,40,40,Initiative,22,22,Land Use: Zoning,5244,31575,36819,0.14242646459708302,M,2,Fail,0,199600019,5244,31575,36819,0.14242646459708302,2,Fail,40,20
199600020,1996,29,1,NEVADA,1996-03-26,NEVADA,0,M,B,"Shall the electorate of the County of Nevada request and direct the California State Legislature to propose an amendment to the California Constitution opposing unfunded Federal and State mandates imposed on local governments and giving local government the legal authority to (a) decline to implement a program mandated by the State or Federal government without the full funding necessary to perform the mandated service, or (b) discontinue a program mandated by the State or Fedeal government when all funds provided by the State or Federal government when all funds provided by the State or Federal government for such a mandate have been expended?",30,30,Advisory,200,40,Governance,23478,5297,28775,0.8159165942658558,M,1,Pass,0,199600020,23478,5297,28775,0.8159165942658558,1,Pass,30,40
199600021,1996,29,1,NEVADA,1996-03-26,NEVADA,0,M,F,"Shall the County of Nevada be required to expend at least one-half of the motor vehicle in lieu taxes received by the County on the maintenance, repair, circulation, enhancement, general road safety and fire access of the public roads, ways, and highways within the County of Nevada?",70,70,Ordinance,62,62,Transport: Roads,17735,12186,29921,0.5927275157915846,M,1,Pass,0,199600021,17735,12186,29921,0.5927275157915846,1,Pass,70,60
199600022,1996,30,1,ORANGE,1996-03-26,ORANGE,0,M,S,"INITIATIVE TO AMEND GENERAL PLAN  MARINE CORPS AIR STATION EL TORO.  Shall the initiative measure entitled ""The El Toro Responsible Economic Development Initiative,"" which would repeal Measure A, abolish the El Toro Airport Citizens Advisory Commission, and which states the highest and best civilian use for Marine Corps Air Station El Toro is not a civilian airport, be approved?",40,40,Initiative,22,22,Land Use: Zoning,195223,287430,482653,0.40447899422566524,M,2,Fail,0,199600022,195223,287430,482653,0.40447899422566524,2,Fail,40,20
199600023,1996,30,1,ORANGE,1996-03-26,ORANGE,0,M,T,"MEASURE TO ADOPT ORANGE COUNTY PROPOSED CHARTER.  Shall the measure entitled ""orange County Proposed Charter"" which would result in Orange County becoming a charter county be adopted?",20,20,Charter Amendment,43,43,Governance: Organization,168545,258961,427506,0.3942517765832526,M,2,Fail,0,199600023,168545,258961,427506,0.3942517765832526,2,Fail,20,40
199600024,1996,30,1,ORANGE,1996-03-26,ORANGE,0,M,U,"MEASURE TO AMEND THE ORANGE COUNTY PROPOSED CHARTER TO INCREASE MEMBERS OF BOARD OF SUPERVISORS FROM FIVE TO NINE.  Shall the measure entitled ""proposed Amendment to Orange County Proposed Charter to Increase Members of Board of Supervisors From Five to Nine"" be adopted?",3,3,Property Tax,43,43,Governance: Organization,111279,339256,450535,0.2469930194102567,M,2,Fail,0,199600024,111279,339256,450535,0.2469930194102567,2,Fail,1,40
199600025,1996,35,1,SAN BENITO,1996-03-26,SAN BENITO,0,M,D,Shall the amended business license tax ordinance increasing the business tax of mining operations be approved?,2,2,Business Tax,100,112,Revenues: Tax Creation/Incr./Contin.,2732,5647,8379,0.3260532283088674,M,2,Fail,0,199600025,2732,5647,8379,0.3260532283088674,2,Fail,1,110
199600026,1996,36,1,SAN BERNARDINO,1996-03-26,SAN BERNARDINO,0,M,L,"Shall an ordinance of the County of San Bernardino be adopted which would prohibit, in the unincorporated portion of the County, large solid waste landfills which overlie or are located within 10 miles from the point of extraction of a significant water resource, unless the large solid waste landfill was fully permitted, constructed and had commenced operations s of March 14, 1995?",70,70,Ordinance,24,24,Land Use: Private Projects,103758,115994,219752,0.47215952528304633,M,2,Fail,0,199600026,103758,115994,219752,0.47215952528304633,2,Fail,70,20
199600027,1996,36,1,SAN BERNARDINO,1996-03-26,SAN BERNARDINO,0,M,M,"Shall the levy of a business license tax on permitted operators of solid waste disposal sites located within the unincorporated territory of the County, as provided in sections 43.031 through 43.037 of the San Bernardino County Code, be approved?",2,2,Business Tax,100,112,Revenues: Tax Creation/Incr./Contin.,88764,125136,213900,0.4149789621318373,M,2,Fail,0,199600027,88764,125136,213900,0.4149789621318373,2,Fail,1,110
199600028,1996,37,1,SAN DIEGO,1996-03-26,SAN DIEGO,0,M,A,PROPOSED AMENDMENT TO THE SAN DIEGO COUNTY CHARTER.  Shall the San Diego County Charter be amended to change the Treasurer/Tax Collector from an elective to an appointive officer appointed by the Chief Administrative Officer?,20,20,Charter Amendment,42,42,Governance: Personnel/Labor Relations,139661,339945,479606,0.2911994428760274,M,2,Fail,0,199600028,139661,339945,479606,0.2911994428760274,2,Fail,20,40
199600029,1996,38,1,SAN FRANCISCO,1996-03-26,SAN FRANCISCO,0,M,A,"Shall the City use lease financing to expand the Moscone Convention Center, if the total owed for this lease financing does not exceed $157.5 million plus interest?",70,70,Ordinance,70,70,Facilities,103680,53005,156685,0.6617097999170309,T,2,FailT,0,199600029,103680,53005,156685,0.6617097999170309,2,FailT,70,70
199600030,1996,38,1,SAN FRANCISCO,1996-03-26,SAN FRANCISCO,0,M,B,Shall various City ordinances be changed so that a ballpark may be built at China Basin?,70,70,Ordinance,24,24,Land Use: Private Projects,108968,55368,164336,0.6630805179631973,M,1,Pass,0,199600030,108968,55368,164336,0.6630805179631973,1,Pass,70,20
199600031,1996,40,1,SAN LUIS OBISPO,1996-03-26,SAN LUIS OBISPO,0,M,B,"Shall limitations be established on the compensation for members of the County Board of Supervisors by: (1) Rescinding San Luis Obispo County Ordinance No. 2695, adopted October 11, 1994, which established the current compensation for members of the Board of Supervisors; and (2) amending San Luis Obispo County Code Section 2.48.095 by deleting certain provisions for establishing compensation for members of the Board of Supervisors based upon a salary survey of six comparable counties, and replacing those provisions with a requirement that salary increases for members of the Board f Supervisors shall be approved by a majority vote of the people?",70,70,Ordinance,41,41,Governance: Benefits/Compensation,46578,15816,62394,0.7465140878930666,M,1,Pass,0,199600031,46578,15816,62394,0.7465140878930666,1,Pass,70,40
199600032,1996,41,1,SAN MATEO,1996-03-26,SAN MATEO,0,M,A,Shall Resolution No. 59915 of the County of San Mateo imposing an annual special tax for fire protection and extended police services according to the schedule therein be approved?,3,3,Property Tax,34,34,Safety: Multiple Emergency Services,1118,283,1401,0.7980014275517487,T,1,PassT,0,199600032,1118,283,1401,0.7980014275517487,1,PassT,1,30
199600033,1996,42,1,SANTA BARBARA,1996-03-26,SANTA BARBARA,0,M,A96,"VOTER APPROVAL OF SOUTH COAST ONSHORE OIL AND GAS SUPPORT FACILITIES OUTSIDE OF EXISTING CONSOLIDATED PROCESSING SITES.  Shall an ordinance be adoptd that required voter approval, for a period of 25 years, of any legislative approval made by the Santa Barbara County Board of Supervisors that authorizes or allows the development, constructtion, installation or expansion of any onshore use, installation or activty on the South Coast of the County of Santa Barbara (from Point Arguello to Venture County border) that proposed to effectuate or support the exploration, development, productin, storage, processing or other activities related to offshore energy resources?",70,70,Ordinance,24,24,Land Use: Private Projects,46412,40146,86558,0.5361953834423161,M,1,Pass,0,199600033,46412,40146,86558,0.5361953834423161,1,Pass,70,20
199600034,1996,42,1,SANTA BARBARA,1996-03-26,SANTA BARBARA,0,M,B96,"BRADLEY FLOOD ZONE.  Shall the Santa Barbara County Flood Control and Water Conservation District be authorized to levy increased benefit assessments on real property in the Bradley Flood Zone, as proposed in its 1995 Flood Control Benefit Assessment Ordinance, adopted December 5, 1995?",3,3,Property Tax,74,73,Facilities: Museum/Cultural/Comm Ctrs,109,287,396,0.27525252525252525,M,2,Fail,0,199600034,109,287,396,0.27525252525252525,2,Fail,1,70
199600035,1996,42,1,SANTA BARBARA,1996-03-26,SANTA BARBARA,0,M,C96,"GUADALUPE FLOOD ZONE.  Shall the Santa Barbara County Flood Control and Water Conservation District be authorized to levy increased benefit assessments on real property in the Guadalupe Flood Zone, as proposed in its 1995 Flood Control Benefit Assessment Ordinance, adopted December 5, 1995?",3,3,Property Tax,74,73,Facilities: Museum/Cultural/Comm Ctrs,199,323,522,0.38122605363984674,M,2,Fail,0,199600035,199,323,522,0.38122605363984674,2,Fail,1,70
199600036,1996,42,1,SANTA BARBARA,1996-03-26,SANTA BARBARA,0,M,D96,"LOMPOC VALLEY FLOOD ZONE.  Shall the Santa Barbara County Flood Control and Water Conservation District be authorized to levy increased benefit assessments on real property in the Lompc Valley Flood Zone, as proposed in its 1995 Flood Control Benefit Assessment Ordinance, adopted December 5, 1995?",3,3,Property Tax,74,73,Facilities: Museum/Cultural/Comm Ctrs,1532,2334,3866,0.39627521986549413,M,2,Fail,0,199600036,1532,2334,3866,0.3962752198654941,2,Fail,1,70
199600037,1996,42,1,SANTA BARBARA,1996-03-26,SANTA BARBARA,0,M,E96,"LOS ALAMOS FLOOD ZONE.  Shall the Santa Barbara County Flood Control and Water Conservation District be authorized to levy increased benefit assessments on real property in the Los Alamos Flood Zone, as proposed in its 1995 Flood Control Benefit Assessment Ordinance, adopted December 5, 1995?",3,3,Property Tax,74,73,Facilities: Museum/Cultural/Comm Ctrs,101,245,346,0.29190751445086704,M,2,Fail,0,199600037,101,245,346,0.29190751445086704,2,Fail,1,70
199600038,1996,42,1,SANTA BARBARA,1996-03-26,SANTA BARBARA,0,M,F96,"ORCUTT FLOOD ZONE.  Shall the Santa Barbara County Flood Control and Water Conservation District be authorized to levy increased benefit assessments on real property in the Orcutt Flood Zone, as proposed in its 1995 Flood Control Benefit Assessment Ordinance, adopted December 5, 1995?",3,3,Property Tax,74,73,Facilities: Museum/Cultural/Comm Ctrs,3443,7522,10965,0.3139990880072959,M,2,Fail,0,199600038,3443,7522,10965,0.3139990880072959,2,Fail,1,70
199600039,1996,42,1,SANTA BARBARA,1996-03-26,SANTA BARBARA,0,M,G96,"SANTA MARIA FLOOD ZONE.  Shall the Santa Barbara County Flood Control and Water Conservation District be authorized to levy increased benefit assessments on real property in the Santa Maria Flood Zone, as proposed in its 1995 Flood Control Benefit Assessment Ordinance, adopted December 5, 1995?",3,3,Property Tax,74,73,Facilities: Museum/Cultural/Comm Ctrs,3587,5221,8808,0.4072434150772026,M,2,Fail,0,199600039,3587,5221,8808,0.4072434150772025,2,Fail,1,70
199600040,1996,42,1,SANTA BARBARA,1996-03-26,SANTA BARBARA,0,M,H96,"SANTA MARIA RIVER LEVEE FLOOD ZONE.  Shall the Santa Barbara County Flood Control and Water Conservation District be authorized to levy increased benefit assessments on real property in the Santa Maria River Levee Flood Zone, as proposed in its 1995 Flood Control Benefit Assessment Ordinance, adopted December 5, 1995?",3,3,Property Tax,74,73,Facilities: Museum/Cultural/Comm Ctrs,3356,4826,8182,0.4101686629186018,M,2,Fail,0,199600040,3356,4826,8182,0.4101686629186018,2,Fail,1,70
199600041,1996,42,1,SANTA BARBARA,1996-03-26,SANTA BARBARA,0,M,I96,"SANTA YNEZ FLOOD ZONE.  Shall the Santa Barbara County Flood Control and Water Conservation District be authorized to levy increased benefit assessments on real property in the , as proposed in its 1995 Flood Control Benefit Assessment Ordinance, adopted December 5, 1995?",3,3,Property Tax,74,73,Facilities: Museum/Cultural/Comm Ctrs,2054,4123,6177,0.33252387890561763,M,2,Fail,0,199600041,2054,4123,6177,0.33252387890561763,2,Fail,1,70
199600042,1996,42,1,SANTA BARBARA,1996-03-26,SANTA BARBARA,0,M,J96,"SOUTH COAST FLOOD ZONE.  Shall the Santa Barbara County Flood Control and Water Conservation District be authorized to levy increased benefit assessments on real property in the South Coast Flood Zone, as proposed in its 1995 Flood Control Benefit Assessment Ordinance, adopted December 5, 1995?",3,3,Property Tax,74,73,Facilities: Museum/Cultural/Comm Ctrs,24424,23810,48234,0.5063648049094001,M,1,Pass,0,199600042,24424,23810,48234,0.5063648049094001,1,Pass,1,70
199600043,1996,43,1,SANTA CLARA,1996-03-26,SANTA CLARA,0,M,A,"AMENDMENT TO THE CHARTER OF THE COUNTY OF SANTA CLARA.  Shall the Santa Clara County Charter be extended to provide for the acquisition, development, maintenance, and operation of parks, without increasing taxes, by continuing the annual transfer from the general fund of an amount estimated to equal one and one-half cents ($0.015 per hundred dollars of assessed valuation of all real and personal property for five years and $0.01425 per one hundred dollars of assessed valuation thereafter for seven years?",20,20,Charter Amendment,51,51,Environment: Parks/Recreation,219874,54208,274082,0.8022197736443838,M,1,Pass,0,199600043,219874,54208,274082,0.8022197736443838,1,Pass,20,50
199600044,1996,46,1,SIERRA,1996-03-26,SIERRA,0,M,A,"Shall the Transient Occupancy Tax currently levied on the occupying of lodging accommodations, including the imposition of such tax on rented reserved outdoor space (recreational vehicle parks, campgrounds, or parking areas) and increasing such tax from 6% to 10% effective January 1993, be ratified and shall the reimposition of the same transient occupancy tax levy adopted by the Sierra County Board of Supervisors by Ordinance No. 835 be approved?",2,2,Business Tax,100,112,Revenues: Tax Creation/Incr./Contin.,852,565,1417,0.6012702893436839,M,1,Pass,0,199600044,852,565,1417,0.6012702893436839,1,Pass,1,110
199600045,1996,52,1,TEHAMA,1996-03-26,TEHAMA,0,M,A,"Shall the Charter of Tehama County be amended by adding Article VI, sections 1 and  2 as ordered by the Board of Supervisors on December 19, 1995 to be placed before the electorate, be adopted and added to the Charter of Tehama County?",20,20,Charter Amendment,200,40,Governance,9096,3966,13062,0.696371152962793,M,1,Pass,0,199600045,9096,3966,13062,0.6963711529627928,1,Pass,20,40
199600046,1996,53,1,TRINITY,1996-03-26,TRINITY,0,M,A,Shall Ordinance No. 1201 adopted by the Trinity County Board of Supervisors establishing a 3% utility tax on electricity and telephone charges be confirmed?,5,5,Utility Tax,100,112,Revenues: Tax Creation/Incr./Contin.,459,4096,4555,0.10076838638858399,T,2,FailT,0,199600046,459,4096,4555,0.10076838638858397,2,FailT,1,110
199600047,1996,53,1,TRINITY,1996-03-26,TRINITY,0,M,B,Shall the Transient Occupancy Tax provided for in Chapter 3.28 of the Trinity County Code be increased to 10%?,2,2,Business Tax,100,112,Revenues: Tax Creation/Incr./Contin.,1051,3466,4517,0.23267655523577596,M,2,Fail,0,199600047,1051,3466,4517,0.23267655523577596,2,Fail,1,110
199600048,1996,53,1,TRINITY,1996-03-26,TRINITY,0,M,C,"If the Transient Occupancy Tax in increased to 10%, should 4% still be dedicated to the promotion and advertisement of Trinity County, as provided for in Chapter 3.28 of the Trinity County Code?",2,2,Business Tax,200,201,Other: Promotion of Tourism,2405,2077,4482,0.536590807675145,M,1,Pass,0,199600048,2405,2077,4482,0.536590807675145,1,Pass,1,200
199600049,1996,55,1,TUOLUMNE,1996-03-26,TUOLUMNE,0,M,G,Shall the County ordinance allowing for the control of rents in mobile home parks be repealed?,70,70,Ordinance,82,82,Housing: Rent Control,5414,10063,15477,0.34980939458551397,M,2,Fail,0,199600049,5414,10063,15477,0.34980939458551397,2,Fail,70,80
199600050,1996,58,1,YUBA,1996-03-26,YUBA,0,M,I,Shall an eight (8) percent transient occupancy tax be imposed upon those businesses providing campgrounds and recreational vehicle parks within the unincorporated area of Yuba County.  The tax shall be collected from every transient and shall be reported by each operator and paid by each operator on or before the last day of the month following each calendar quarter as prescribed from time to time by the Yuba County Treasurer/Tax Collector?,2,2,Business Tax,100,112,Revenues: Tax Creation/Incr./Contin.,4334,5973,10307,0.4204909284951975,M,2,Fail,0,199600050,4334,5973,10307,0.4204909284951974,2,Fail,1,110
199600051,1996,58,1,YUBA,1996-03-26,YUBA,0,M,J,"Shall an eight cent per ton mineral depletion special purpose tax on mined minerals be imposed on those businesses engaged in the mining of minerals from land repair, maintenance and reconstruction of county streets and roads?",2,2,Business Tax,54,54,Environment: Regulation/Mitigation,5190,6147,11337,0.4577930669489283,M,2,Fail,0,199600051,5190,6147,11337,0.4577930669489283,2,Fail,1,50
199600052,1996,1,2,ALAMEDA,1996-03-26,ALAMEDA,0,M,C,Shall an ordinance be adopted forming a citywide assessment district to provide funds to build a new main library and to rehabilitate and seismically upgrade the Carnegie Building for use as a museum or other public purpose through the levy of an annual assessment that shall not exceed $68.50 on residential properties and a proportionate annual assessment on non-residential properties for up to 30 years?,3,3,Property Tax,71,71,Facilities: Libraries,7067,9375,16442,0.4298138912541054,T,2,FailT,0,199600052,7067,9375,16442,0.42981389125410535,2,FailT,1,70
199600053,1996,1,2,ALAMEDA,1996-03-26,ALAMEDA,0,M,D,Shall the Charter of the City of Alameda be amended to require newspapers to be adjudicated as a newspaper of general circulation within the City of Alameda to qualify to publish the City=s legal advertisements in lieu of the current Charter requirements that a newspaper have been published for at least one year in the City and that it have a bona fide paid circulation of at least one thousand copies?,20,20,Charter Amendment,40,40,Governance,8867,5998,14865,0.596501849983182,M,1,Pass,0,199600053,8867,5998,14865,0.596501849983182,1,Pass,20,40
199600054,1996,1,2,ALAMEDA,1996-03-26,OAKLAND,0,M,E,"Shall Section 2601(e) of the Charter of the City of Oakland be amended to provide that a maximum of fifty percent (50%) of all invested funds of the Police and Fire Retirement System may be invested in common stocks and mutual funds; and that the Police and Fire Retirement Board may approve, on a case by case basis, the purchase  of common stocks that have not paid a cash dividend for the five years next preceding the date of investment?",20,20,Charter Amendment,34,34,Safety: Multiple Emergency Services,35251,19912,55163,0.6390334100755941,M,1,Pass,0,199600054,35251,19912,55163,0.6390334100755941,1,Pass,20,30
199600055,1996,1,2,ALAMEDA,1996-03-26,OAKLAND,0,M,F,"Shall Section 2601 of the Charter of the City of Oakland be amended to provide that in the event no active member of the Police or Fire Department is willing to serve on the Police and Fire Retirement Board in the positions designated for such members, the retired and active membership of the Police or Fire Department, as the case may be, shall elect a retired member of such department to serve in such position?",20,20,Charter Amendment,34,34,Safety: Multiple Emergency Services,40772,14830,55602,0.7332829754325384,M,1,Pass,0,199600055,40772,14830,55602,0.7332829754325384,1,Pass,20,30
199600056,1996,1,2,ALAMEDA,1996-03-26,OAKLAND,0,M,G,"Shall Sections 710, 808, and 900 of the Charter of the City of Oakland be amended to provide appropriate remedies for race and gender discrimination and imbalances in contracting and hiring practices?",20,20,Charter Amendment,34,34,Safety: Multiple Emergency Services,37192,20581,57773,0.6437609263842972,M,1,Pass,0,199600056,37192,20581,57773,0.6437609263842972,1,Pass,20,30
199600057,1996,1,2,ALAMEDA,1996-03-26,OAKLAND,0,M,H,"Shall Section 2002 of the Charter of the City of Oakland be amended to provide that in the event that less than three members of the Oakland Municipal Employees= Retirement System are elected to serve in the three seats of the Oakland Municipal Employees= Retirement System Board designated for such members, the retirement system members may elect widows, widowers and beneficiaries to the vacant seats designated for active, retired and deferred members of the retirement system?",20,20,Charter Amendment,42,42,Governance: Personnel/Labor Relations,33736,19053,52789,0.6390725340506545,M,1,Pass,0,199600057,33736,19053,52789,0.6390725340506545,1,Pass,20,40
199600058,1996,1,2,ALAMEDA,1996-03-26,OAKLAND,0,M,I,Shall the City of Oakland impose a Special Tax to provide funds necessary for services to the elderly?,3,3,Property Tax,200,112,Revenues: Tax Creation/Incr./Contin.,38939,23149,62088,0.6271582270325989,T,2,FailT,0,199600058,38939,23149,62088,0.6271582270325989,2,FailT,1,110
199600059,1996,1,2,ALAMEDA,1996-03-26,OAKLAND,0,M,J,Shall Section 1205 of the Charter of the City of Oakland be amended to provide that the City Council shall annually designate the official newspaper of the City of Oakland?,20,20,Charter Amendment,200,40,Governance,22426,34131,56557,0.3965203246282512,M,2,Fail,0,199600059,22426,34131,56557,0.39652032462825115,2,Fail,20,40
199600060,1996,4,2,BUTTE,1996-03-26,PARADISE,0,M,B,"Shall Ordinance No. 263, an Ordinance of the Town Council of the Town of Paradise, authorizing the Town Council for general municipal purposes to set a utility users tax, not exceeding three percent (3%), upon the users of gas, electrical energy cable television and intrastate telephone services provided within the Town of Paradise be approved?",5,5,Utility Tax,100,100,General Services,3206,6062,9268,0.3459214501510574,M,2,Fail,0,199600060,3206,6062,9268,0.3459214501510574,2,Fail,1,100
199600061,1996,7,2,CONTRA COSTA,1996-03-26,ANTIOCH,0,R,1,Shall ALLEN PAYTON be recalled from the office of City Council?,50,50,Recall,48,46,Governance: Recall,7143,7775,14918,0.47881753586271625,M,2,Fail,0,199600061,7143,7775,14918,0.4788175358627162,2,Fail,50,40
199600062,1996,7,2,CONTRA COSTA,1996-03-26,ANTIOCH,0,R,2,Shall ELIZABETH RIMBAULT be recalled from the office of City Council?,50,50,Recall,48,46,Governance: Recall,7753,6809,14562,0.5324131300645516,M,1,Pass,0,199600062,7753,6809,14562,0.5324131300645516,1,Pass,50,40
199600063,1996,7,2,CONTRA COSTA,1996-03-26,DANVILLE,0,M,E,"Shall Town of Danville Ordinance 95-5 approving a preliminary development plan-rezoning (PUD 95-01) (APN:206-010-050-Shadowhawk II, Kaufman & Broad), become effective?",70,70,Ordinance,22,22,Land Use: Zoning,3963,7451,11414,0.3472051866129315,M,2,Fail,0,199600063,3963,7451,11414,0.3472051866129315,2,Fail,70,20
199600064,1996,7,2,CONTRA COSTA,1996-03-26,MARTINEZ,0,M,D,Shall the ordinance creating a Utility Users Tax be adopted?,5,5,Utility Tax,200,112,Revenues: Tax Creation/Incr./Contin.,3529,5694,9223,0.3826303805703134,T,2,FailT,0,199600064,3529,5694,9223,0.38263038057031334,2,FailT,1,110
199600065,1996,7,2,CONTRA COSTA,1996-03-26,WALNUT CREEK,0,M,B,Shall the ordinance increasing the Transient Occupancy Tax (Hotel-Motel Tax) from the existing 8.5% to 10% and capping any future increases at 12% be approved?,2,2,Business Tax,200,112,Revenues: Tax Creation/Incr./Contin.,8736,12221,20957,0.4168535572839624,M,2,Fail,0,199600065,8736,12221,20957,0.4168535572839624,2,Fail,1,110
199600066,1996,7,2,CONTRA COSTA,1996-03-26,WALNUT CREEK,0,M,C,Shall the office of city treasurer be appointive?,20,20,Charter Amendment,42,42,Governance: Personnel/Labor Relations,7925,11488,19413,0.4082315973831968,M,2,Fail,0,199600066,7925,11488,19413,0.4082315973831968,2,Fail,20,40
199600067,1996,10,2,FRESNO,1996-03-26,CLOVIS,0,M,B,Shall the City of Clovis be authorized to increase the City's Transient Occupancy Tax to ten percent (10%) as provided in Ordinance 95-31?,2,2,Business Tax,200,112,Revenues: Tax Creation/Incr./Contin.,7634,6939,14573,0.5238454676456461,M,1,Pass,0,199600067,7634,6939,14573,0.5238454676456461,1,Pass,1,110
199600068,1996,10,2,FRESNO,1996-03-26,FRESNO,0,M,C,"Amend Section 1400 of the Charter, DIRECT PRIMARY AND GENERAL MUNICIPAL ELECTIONS, to allow municipal elections to be held the same date as the statewide direct primary and general elections.",20,20,Charter Amendment,48,48,Governance: Elections,51701,8905,60606,0.853067353067353,M,1,Pass,0,199600068,51701,8905,60606,0.853067353067353,1,Pass,20,40
199600069,1996,10,2,FRESNO,1996-03-26,FRESNO,0,M,D,"Amend Section 810 of the Charter, HOURS OF WORK, to read:  There shall not be established for any position in the city service a regularly scheduled work day of more than eight hours or a regularly scheduled work week of more than five days, except that there may be established a regularly scheduled work day of up to ten hours for any position for which the regularly scheduled work week is not more than four days, or any other work week mutually agreed to between the City and a non-represented employee or between the City and a recognized employee organization.  A member of the city fire fighting force shall be required to work, on a twenty-four hour day basis, not more than fifty-six hours per week on an average, said average to be determined in multiples not to exceed ninety days.",20,20,Charter Amendment,33,33,Safety: Fire,36646,21662,58308,0.6284900871235508,M,1,Pass,0,199600069,36646,21662,58308,0.6284900871235508,1,Pass,20,30
199600070,1996,10,2,FRESNO,1996-03-26,FRESNO,0,M,E,"Amend Section 502 of the Charter, MEETINGS, to read:  The Council shall hold regular meetings and shall provide the time, place and manner of holding its meetings by resolution.  All meetings of the Council shall be opened to the public, except executive sessions permitted by the law of the State.",20,20,Charter Amendment,43,43,Governance: Organization,35088,22314,57402,0.6112679000731682,M,1,Pass,0,199600070,35088,22314,57402,0.6112679000731682,1,Pass,20,40
199600071,1996,10,2,FRESNO,1996-03-26,FRESNO,0,M,F,"Amend Section 1210 of the Charter, TEMPORARY LOANS, to read:  Money may be borrowed in anticipation of the receipts from taxes during any fiscal year, by the issue of notes, certificates of indebtedness or revenue bonds; but the aggregate amount of such loans at any time outstanding shall not exceed the amount authorized by applicable federal and California law; and all such loans shall be paid out of the receipts from taxes for the fiscal year in which they are issued.",20,20,Charter Amendment,40,40,Governance,38821,17477,56298,0.689562684287186,M,1,Pass,0,199600071,38821,17477,56298,0.689562684287186,1,Pass,20,40
199600072,1996,10,2,FRESNO,1996-03-26,FRESNO,0,M,G,"Amend Section 1208 of the Charter, COMPETITIVE BIDDING, to increase minimum contract amount from $25,000 to $27,000 subject to competitive bidding, and minimum amount will be adjusted on the first of July to the nearest $1,000 in response to changes in the CPI.  Also allows a five percent preference for local businesses.",20,20,Charter Amendment,47,47,Governance: Contracting/Bidding/Leasing,30922,23674,54596,0.5663784892666129,M,1,Pass,0,199600072,30922,23674,54596,0.5663784892666129,1,Pass,20,40
199600073,1996,10,2,FRESNO,1996-03-26,FRESNO,0,M,H,"Amend Section 801 of the Charter, Administrative Departments, to allow the Council to provide for the organization, conduct and operation of Charter established offices and the creation, consolidation, alteration or abolition of any City department, division, office or agency by resolution.",20,20,Charter Amendment,43,43,Governance: Organization,29626,26795,56421,0.5250881763882242,M,1,Pass,0,199600073,29626,26795,56421,0.5250881763882242,1,Pass,20,40
199600074,1996,10,2,FRESNO,1996-03-26,FRESNO,0,M,I,"Amend Section 910 of the Charter, RETIREMENT AND/OR PENSION BOARDS, to allow the Retirement Boards to appoint and direct a Retirement Administrator who shall report to the Board, administer the retirement office and its financial affairs as directed by the Board, and shall serve at the pleasure of the Board.",20,20,Charter Amendment,41,41,Governance: Benefits/Compensation,28461,27855,56316,0.5053803537183038,M,1,Pass,0,199600074,28461,27855,56316,0.5053803537183038,1,Pass,20,40
199600075,1996,10,2,FRESNO,1996-03-26,REEDLEY,0,M,J,Shall the office of City Treasurer by appointive?,70,70,Ordinance,42,42,Governance: Personnel/Labor Relations,1701,1379,3080,0.5522727272727272,M,1,Pass,0,199600075,1701,1379,3080,0.5522727272727272,1,Pass,70,40
199600076,1996,13,2,IMPERIAL,1996-03-26,CALEXICO,0,M,Z,"Should the City of Calexico enter into a Joint Powers Agreement with the Heffernan Memorial Hospital District in which the City of Calexico, through and by the City Council, would assume operation, management, and control of Calexico Hospital wth the half cent sales tax currently in efect to continue to the benefit of the Calexico Hospital?",70,70,Ordinance,72,72,Facilities: Health Facilities,1329,1387,2716,0.48932253313696616,M,2,Fail,0,199600076,1329,1387,2716,0.4893225331369661,2,Fail,70,70
199600077,1996,15,2,KERN,1996-03-26,BAKERSFIELD,0,M,D,Shall Section 17 of the City Charter be amended to prohibit a councilmember from residing outside the ward from which he or she is elected?,20,20,Charter Amendment,48,48,Governance: Elections,28136,7755,35891,0.7839291187205706,M,1,Pass,0,199600077,28136,7755,35891,0.7839291187205706,1,Pass,20,40
199600078,1996,15,2,KERN,1996-03-26,BAKERSFIELD,0,M,E,"Shall Section (185)3 of the City Charter be modified to allow that any member of the Fire Department may be appointed Assistant Chief of Deputy Chief, as is currently the case with the Chief of the Fire Department.",20,20,Charter Amendment,33,33,Safety: Fire,28371,6419,34790,0.8154929577464789,M,1,Pass,0,199600078,28371,6419,34790,0.8154929577464789,1,Pass,20,30
199600079,1996,15,2,KERN,1996-03-26,BAKERSFIELD,0,M,F,Shall Section (217b)10 of the City Charter be repealed to bring the lay-off policy into compliance with current labor agreements?,20,20,Charter Amendment,42,42,Governance: Personnel/Labor Relations,26136,7753,33889,0.7712237009058986,M,1,Pass,0,199600079,26136,7753,33889,0.7712237009058986,1,Pass,20,40
199600080,1996,15,2,KERN,1996-03-26,CALIFORNIA CITY,0,M,G,"Shall an annual special tax for street maintenance and repair be approved pursuant to Government Code Section 50075 in the amount of $25.00 per lot or parcel for a five year period beginning July 1, 1996?",3,3,Property Tax,74,73,Facilities: Museum/Cultural/Comm Ctrs,885,957,1842,0.48045602605863197,T,2,FailT,0,199600080,885,957,1842,0.4804560260586319,2,FailT,1,70
199600081,1996,15,2,KERN,1996-03-26,CALIFORNIA CITY,0,M,H,"Shall an annual special tax for police services be approved pursuant to Government Code section 50075 in the amount of $20.00 per lot or parcel for a five year period beginning July 1, 1996?",3,3,Property Tax,32,32,Safety: Police,906,930,1836,0.4934640522875817,T,2,FailT,0,199600081,906,930,1836,0.4934640522875817,2,FailT,1,30
199600082,1996,19,2,LOS ANGELES,1996-03-26,ALHAMBRA,0,M,A,"CHARTER AMENDMENT NO. 1.  Shall the Alhambra City Charter be amended to divide the Alhambra School District and Alhambra High School district into five geographic districts from which candidates for membership on the Alhambra Board of Education shall be nominated, all of which amendments are shown in the ballot pamphlet?",20,20,Charter Amendment,12,12,Education: Districts,8267,7180,15447,0.5351848255324658,M,1,Pass,0,199600082,8267,7180,15447,0.5351848255324658,1,Pass,20,10
199600083,1996,19,2,LOS ANGELES,1996-03-26,ALHAMBRA,0,M,B,"CHARTER AMENDMENT NO. 2.  Shall the Alhambra City Charter be amended to eliminate outdated provisions, to include gender-neutral language, and to reaffirm the City's control over matters of local concern by providing that the City Council may legislate on issues which are municipal affairs as is authorized by the Constitution of the State of California, all of which amendments are shown in the ballot pamphlet?",20,20,Charter Amendment,43,43,Governance: Organization,5815,3290,9105,0.6386600768808347,M,1,Pass,0,199600083,5815,3290,9105,0.6386600768808347,1,Pass,20,40
199600084,1996,19,2,LOS ANGELES,1996-03-26,BEVERLY HILLS,0,M,C,"Shall an ordinance of the City of Beverly Hills be adopted to validate, re-enact and approve the increase in the transient occupancy tax from 11% to the current rate of 14% of the rent charge for a hotel room?",2,2,Business Tax,200,112,Revenues: Tax Creation/Incr./Contin.,4191,2252,6443,0.6504733819649232,T,2,FailT,0,199600084,4191,2252,6443,0.6504733819649232,2,FailT,1,110
199600085,1996,19,2,LOS ANGELES,1996-03-26,DIAMOND BAR,0,M,D,"Shall the initiative proposing the adoption of the General Plan document prepared by the General Plan Advisory Committee, along with certain specified changes, repealing and replacing the City's current General Plan, be adopted?",40,40,Initiative,22,22,Land Use: Zoning,2985,5909,8894,0.3356195187767034,M,2,Fail,0,199600085,2985,5909,8894,0.3356195187767034,2,Fail,40,20
199600086,1996,19,2,LOS ANGELES,1996-03-26,HAWTHORNE,0,M,E,Shall the City of Hawthorne contract with the County of Los Angeles Fire Protection District to duplicate the existing level of Fire Service?,30,30,Advisory,33,33,Safety: Fire,4711,2411,7122,0.66147149677057,M,1,Pass,0,199600086,4711,2411,7122,0.66147149677057,1,Pass,30,30
199600087,1996,19,2,LOS ANGELES,1996-03-26,HERMOSA BEACH,0,M,F,"Shall the Ordinance which would increase the Utility Users Tax, imposed pursuant to Article VI of Chapter 30 of the Hermosa Beach Municipal Code, from six percent (6%) to eight (8%) be adopted?",5,5,Utility Tax,100,112,Revenues: Tax Creation/Incr./Contin.,1609,3047,4656,0.34557560137457044,M,2,Fail,0,199600087,1609,3047,4656,0.34557560137457044,2,Fail,1,110
199600088,1996,19,2,LOS ANGELES,1996-03-26,LA HABRA HEIGHTS,0,M,G,"Shall Ordinance 209 be adopted to validate, re-enact, and amend a business license tax on oil and gas wells in the City?",2,2,Business Tax,100,112,Revenues: Tax Creation/Incr./Contin.,1308,263,1571,0.8325907065563335,M,1,Pass,0,199600088,1308,263,1571,0.8325907065563335,1,Pass,1,110
199600089,1996,19,2,LOS ANGELES,1996-03-26,MANHATTAN BEACH,0,M,H,Shall the office of City Clerk be appointive?,70,70,Ordinance,42,42,Governance: Personnel/Labor Relations,4768,4631,9399,0.5072880093626981,M,1,Pass,0,199600089,4768,4631,9399,0.5072880093626981,1,Pass,70,40
199600090,1996,19,2,LOS ANGELES,1996-03-26,MANHATTAN BEACH,0,M,I,Shall the office of City Treasurer be appointive?,70,70,Ordinance,42,42,Governance: Personnel/Labor Relations,4226,5101,9327,0.4530931703656053,M,2,Fail,0,199600090,4226,5101,9327,0.45309317036560526,2,Fail,70,40
199600091,1996,19,2,LOS ANGELES,1996-03-26,MANHATTAN BEACH,0,M,J,Shall an ordinance be adopted which limits a Member of the City Council to serving two (2) consecutive terms with a provision which allows a Member to hold office again after being out of office for a period of at least two (2) years?,70,70,Ordinance,45,45,Governance: Political Reform/Term Limits,6507,3060,9567,0.6801505174035748,M,1,Pass,0,199600091,6507,3060,9567,0.6801505174035748,1,Pass,70,40
199600092,1996,19,2,LOS ANGELES,1996-03-26,MANHATTAN BEACH,0,M,K,Shall an ordinance be adopted which limits a Member of the City Council to serving two (2) terms with a provision declaring a Member ineligible to hold office thereafter (a lifetime ban on renewed service)?,70,70,Ordinance,45,45,Governance: Political Reform/Term Limits,3211,6269,9480,0.33871308016877644,M,2,Fail,0,199600092,3211,6269,9480,0.3387130801687764,2,Fail,70,40
199600093,1996,19,2,LOS ANGELES,1996-03-26,SANTA MONICA,0,M,L,"Shall City Charter Section 2015C be added to the City Charter to increase the City's expenditure limitation for each fiscal year during the four year period ending March 25, 2000, by an amount equal to monies received pursuant to the City Charter Section 2008 from owners in connection with tenant-approved conversions of rental units, and monies received pursuant to Charter Section 2008 in previous fiscal years and not yet expended?",20,20,Charter Amendment,100,49,Governance: Budget Processes,9886,7109,16995,0.5817005001471021,M,1,Pass,0,199600093,9886,7109,16995,0.5817005001471021,1,Pass,20,40
199600094,1996,19,2,LOS ANGELES,1996-03-26,SANTA MONICA,0,M,M,"Shall the City Charter be amended by adding Section 1908 to increase the City's expenditure limitation by $25,300,000.00 for each fiscal year during the four year period ending March 25, 2000, for the purposes of maintaining and providing increased police services, for aid to public schools, for maintaining basic City services, and for other specified purposes such as capital improvements and outlays for parks, street lighting, libraries and police facilities?",20,20,Charter Amendment,100,49,Governance: Budget Processes,12276,5879,18155,0.6761773616083724,M,1,Pass,0,199600094,12276,5879,18155,0.6761773616083724,1,Pass,20,40
199600095,1996,20,2,MADERA,1996-03-26,CHOWCHILLA,0,R,1,Shall KATHRYN HORN be recalled (removed) from the office of Chowchilla City Council?,50,50,Recall,48,46,Governance: Recall,984,407,1391,0.7074047447879224,M,1,Pass,0,199600095,984,407,1391,0.7074047447879224,1,Pass,50,40
199600096,1996,20,2,MADERA,1996-03-26,CHOWCHILLA,0,R,2,Shall LINDA R. PISTORESI be recalled (removed) from the office of Chowchilla City Council?,50,50,Recall,48,46,Governance: Recall,1021,356,1377,0.7414669571532316,M,1,Pass,0,199600096,1021,356,1377,0.7414669571532316,1,Pass,50,40
199600097,1996,20,2,MADERA,1996-03-26,CHOWCHILLA,0,R,3,Shall ROY E. PRICE be recalled (removed) from the office o Chowchilla City Council?,50,50,Recall,48,46,Governance: Recall,1014,357,1371,0.7396061269146609,M,1,Pass,0,199600097,1014,357,1371,0.7396061269146609,1,Pass,50,40
199600098,1996,21,2,MARIN,1996-03-26,BELVEDERE,0,M,A,"Shall the City of Belvedere be authorized to continue its levy for fire protection and emergency medical services for the period July 1. 1996 through June 30, 2000, and thereby adjust its appropriations limit, as provided for in Article XIIIB of the California Constitution, with the understanding that the maximum levy for 1995-96 of $195 per residential dwelling unit, $246 per commercial occupancy and $56 per vacant parcel shall not exceed the rate currently authorized in Chapter 3.28 of the Belvedere Municipal Code?",60,60,Gann Limit,33,33,Safety: Fire,823,67,890,0.9247191011235956,M,1,Pass,0,199600098,823,67,890,0.9247191011235955,1,Pass,60,30
199600099,1996,21,2,MARIN,1996-03-26,ROSS,0,M,B,"Shall the ordinance authorizing levy of the general municipal services tax from July 1, 1996 through June 30, 2000, thereby increasing the appropriations limit of the Town of Ross, be adopted?",60,60,Gann Limit,40,40,Governance,592,232,824,0.7184466019417477,M,1,Pass,0,199600099,592,232,824,0.7184466019417476,1,Pass,60,40
199600100,1996,21,2,MARIN,1996-03-26,TIBURON,0,M,C,"Shall the Town of Tiburon be authorized to implement a special parcel tax to raise $400,000 annually for a five (5) year period soley for the purpose of constructing improvements to the Town's Streets System, and be authorized to levy an annual parcel tax of $143 for the following:  Each commercial parcel; Each single family residential dwelling unit; Each unimproved single family or multi-family residential parcel; the first unit on each \improved multi-family residential parcel\l, plus $72 for each additional unit on that parcel with exemptions for non-buildable parcels, for homeowners qualified under the PG&E Lifeline energy assistance program, and for low/very low income units in the Hilarita, Bradley House and Tiburon Hills Estates developments; and with the provision that assessments may be prepaid in their entirety at 87% of the full assessment at the option of the property owner?",3,3,Property Tax,74,73,Facilities: Museum/Cultural/Comm Ctrs,1311,1500,2811,0.4663820704375667,T,2,FailT,0,199600100,1311,1500,2811,0.4663820704375667,2,FailT,1,70
199600101,1996,23,2,MENDOCINO,1996-03-26,UKIAH,0,M,A,Shall the office of City Clerk be appointive?,70,70,Ordinance,42,42,Governance: Personnel/Labor Relations,1718,1847,3565,0.4819074333800841,M,2,Fail,0,199600101,1718,1847,3565,0.4819074333800841,2,Fail,70,40
199600102,1996,23,2,MENDOCINO,1996-03-26,UKIAH,0,M,B,Shall the office of City Treasurer be appointive?,70,70,Ordinance,42,42,Governance: Personnel/Labor Relations,1651,1933,3584,0.46065848214285715,M,2,Fail,0,199600102,1651,1933,3584,0.46065848214285715,2,Fail,70,40
199600103,1996,26,2,MONO,1996-03-26,MAMMOTH LAKES,0,M,A,"Shall the ordinance which will extend the Utility Tax and Transient Occupancy Tax, and which will ratify prior collection of such taxes, be adopted?",5,5,Utility Tax,100,112,Revenues: Tax Creation/Incr./Contin.,880,634,1514,0.5812417437252312,M,1,Pass,0,199600103,880,634,1514,0.5812417437252312,1,Pass,1,110
199600104,1996,28,2,NAPA,1996-03-26,NAPA,0,M,A,Shall the Charter of the City of Napa be amended to transfer the power to fix compensation for the City's public safety employees and to establish other terms and conditions of such employees' employment from the Napa City Council to a panel of arbitrators whenever the unions and the City Council cannot reach agreement as to compensation or other terms and conditions of employment?,20,20,Charter Amendment,41,41,Governance: Benefits/Compensation,12846,7862,20708,0.6203399652308287,M,1,Pass,0,199600104,12846,7862,20708,0.6203399652308287,1,Pass,20,40
199600105,1996,28,2,NAPA,1996-03-26,NAPA,0,M,B,"Shall the Charter of the City of Napa be amended to identify the scope of binding arbitration as including wages and benefits, and not matters of public policy or other terms and conditions of employment?  This amendment would only be effective if the voters enact Measure A, which would require binding arbitration in labor disputes involving public safety employees.",20,20,Charter Amendment,41,41,Governance: Benefits/Compensation,6845,13382,20227,0.33840905720077125,M,2,Fail,0,199600105,6845,13382,20227,0.33840905720077125,2,Fail,20,40
199600106,1996,28,2,NAPA,1996-03-26,NAPA,0,M,C,"Shall the Charter of the City of Napa be amended to require voter approval (2/3) vote) at the next regular election for any financial award by the binding arbitration panel which exceeds the last best offer of the City?  This amendment would only be effective if the voters enact Measure A, which would require binding arbitration in labor disputes involving public safety employees.",20,20,Charter Amendment,41,41,Governance: Benefits/Compensation,6012,13992,20004,0.3005398920215957,M,2,Fail,0,199600106,6012,13992,20004,0.3005398920215957,2,Fail,20,40
199600107,1996,28,2,NAPA,1996-03-26,NAPA,0,M,D,"Shall the Charter of the City of Napa be amended to define timeliness in the public safety employee binding arbitration initiative?  This amendment would only be effective in the voters inact Measure A, which would require binding arbitration in labor disputes involving public safety employees.",20,20,Charter Amendment,41,41,Governance: Benefits/Compensation,6360,13542,19902,0.31956587277660536,M,2,Fail,0,199600107,6360,13542,19902,0.31956587277660536,2,Fail,20,40
199600108,1996,28,2,NAPA,1996-03-26,NAPA,0,M,E,"Shall the Charter of the City of Napa be amended to prohibit binding arbitration during the term of any MOU (Memorandum of Understanding) between the City public safety employees?  This amendment would only be effective if the voters enact Measure A, which would require binding arbitration in labor disputes involving public safety employees.",20,20,Charter Amendment,41,41,Governance: Benefits/Compensation,5676,13692,19368,0.2930607187112763,M,2,Fail,0,199600108,5676,13692,19368,0.2930607187112763,2,Fail,20,40
199600109,1996,28,2,NAPA,1996-03-26,NAPA,0,M,F,"Shall the Charter of the City of Napa be amended to define the criteria to be used by the arbitration panel in reaching decisions and require the panel to issue written findings on each of the criteria?  This amendment would only be effective if the voters enact Measure A, which would require binding arbitration in labor disputes involving public safety employees.",20,20,Charter Amendment,41,41,Governance: Benefits/Compensation,5635,13742,19377,0.29080869071579707,M,2,Fail,0,199600109,5635,13742,19377,0.29080869071579707,2,Fail,20,40
199600110,1996,30,2,ORANGE,1996-03-26,BREA,0,M,V,Shall the office of city treasurer be appointive?,70,70,Ordinance,42,42,Governance: Personnel/Labor Relations,3092,3878,6970,0.4436154949784792,M,2,Fail,0,199600110,3092,3878,6970,0.4436154949784792,2,Fail,70,40
199600111,1996,30,2,ORANGE,1996-03-26,BREA,0,M,W,Shall the office of city clerk be appointive?,70,70,Ordinance,42,42,Governance: Personnel/Labor Relations,3287,3667,6954,0.4726775956284153,M,2,Fail,0,199600111,3287,3667,6954,0.4726775956284153,2,Fail,70,40
199600112,1996,30,2,ORANGE,1996-03-26,DANA POINT,0,R,X,Shall KAREN LLOREDA be recalled (removed) from the office of Member of the City Council?,50,50,Recall,48,46,Governance: Recall,4668,4868,9536,0.48951342281879195,M,2,Fail,0,199600112,4668,4868,9536,0.48951342281879195,2,Fail,50,40
199600113,1996,30,2,ORANGE,1996-03-26,DANA POINT,0,R,Y,Shall HAROLD R. KAUFMAN be recalled (removed) from the office of Member of the City Council?,50,50,Recall,48,46,Governance: Recall,4421,4828,9249,0.4779976213644719,M,2,Fail,0,199600113,4421,4828,9249,0.4779976213644718,2,Fail,50,40
199600114,1996,30,2,ORANGE,1996-03-26,GARDEN GROVE,0,M,AA,"Shall a new Ordinance which continues the transient occupancy tax increment of 2% (tax on renting of hotel and motel rooms,\), adopted in 1992-92 as established by Garden Grove Municipal Code Chapter 3.12, be adopted?",2,2,Business Tax,100,112,Revenues: Tax Creation/Incr./Contin.,10464,8626,19090,0.5481403876375065,M,1,Pass,0,199600114,10464,8626,19090,0.5481403876375065,1,Pass,1,110
199600115,1996,30,2,ORANGE,1996-03-26,GARDEN GROVE,0,M,BB,"Shall a new ordinance which continues the business license tax based on gross receipts of the City of Garden Grove, adopted in 1991, as established by Title 5 of the Garden Grove Municipal Code entitled ""Business Operation Taxes, Permits and Regulations"" be adopted?",2,2,Business Tax,100,112,Revenues: Tax Creation/Incr./Contin.,8951,9889,18840,0.4751061571125266,M,2,Fail,0,199600115,8951,9889,18840,0.4751061571125265,2,Fail,1,110
199600116,1996,30,2,ORANGE,1996-03-26,GARDEN GROVE,0,M,CC,"Shall an initiative ordinance to replace the existing water rate system of fees and charges of the City of Garden Grove, with a new system of standards and requirements to set fees and rates for water usage in the City of Garden Grove, including, among other things, the requirement that all water users be charged the same rates regardless of the volume of water used, nature of the user's business, size of lot, or structures on the lot, be adopted?",40,40,Initiative,104,104,General Services: Water,5151,14774,19925,0.2585194479297365,M,2,Fail,0,199600116,5151,14774,19925,0.2585194479297365,2,Fail,40,100
199600117,1996,30,2,ORANGE,1996-03-26,GARDEN GROVE,0,M,DD,Shall an Ordinance requiring the maintenance of the current water operation system and rate structure be adopted?,70,70,Ordinance,104,104,General Services: Water,9576,9628,19204,0.49864611539262654,M,2,Fail,0,199600117,9576,9628,19204,0.49864611539262654,2,Fail,70,100
199600118,1996,30,2,ORANGE,1996-03-26,GARDEN GROVE,0,M,Z,Shall an Ordinance establishing term limits of two consecutive four-year terms for the office of councilmember and four consecutive two-year terms for the office of mayor be adopted?,70,70,Ordinance,45,49,Governance: Political Reform/Term Limits,14573,5234,19807,0.7357499873781997,M,1,Pass,0,199600118,14573,5234,19807,0.7357499873781996,1,Pass,70,40
199600119,1996,30,2,ORANGE,1996-03-26,HUNTINGTON BEACH,0,M,EE,"Shall proposed Charter Amendment No. 1, amending Sections 300 and 311 of the Charter of the City of Huntington Beach changing the City Treasurer from an elective office to a position screened by a citizens' committee and appointed by the City Administrator with the approval of the City Council, be approved?",20,20,Charter Amendment,42,42,Governance: Personnel/Labor Relations,16287,20756,37043,0.439678211807899,M,2,Fail,0,199600119,16287,20756,37043,0.43967821180789896,2,Fail,20,40
199600120,1996,30,2,ORANGE,1996-03-26,HUNTINGTON BEACH,0,M,FF,"Shall proposed Charter Amendment No. 2, amending Sections 300 and 309 of the Charter of the City of Huntington Beach changing the City Attorney from an elective office to a position screened by a citizens' committee and appointed by the City Administrator with the approval of the City Council, be approved?",20,20,Charter Amendment,42,42,Governance: Personnel/Labor Relations,14082,22834,36916,0.3814606132842128,M,2,Fail,0,199600120,14082,22834,36916,0.3814606132842128,2,Fail,20,40
199600121,1996,30,2,ORANGE,1996-03-26,HUNTINGTON BEACH,0,M,GG,"ADVISORY VOTE ONLY.  Should City of Huntington Beach acquire, develop, improve, maintain sorts fields for soccer, football, softball, baseball, and other sports; replace restrooms, bicycle/pedestrian trails, lighting, and showers on city beach; acquire senior center site; develop swim complex; and improve neighborhood arks and tot lots by establishing a citywide assessment district not to exceed thirty years or a cost of: $12 annually per mobile home unit; $24 annually per apartment unit; $36 annually per residential, commercial and industrial unit?",30,30,Advisory,51,51,Environment: Parks/Recreation,17829,20435,38264,0.4659471043278277,M,2,Fail,0,199600121,17829,20435,38264,0.4659471043278277,2,Fail,30,50
199600122,1996,30,2,ORANGE,1996-03-26,ORANGE,0,M,HH,Shall the office of City Treasurer by appointive?,70,70,Ordinance,42,42,Governance: Personnel/Labor Relations,8730,12428,21158,0.41260988751299743,M,2,Fail,0,199600122,8730,12428,21158,0.41260988751299743,2,Fail,70,40
199600123,1996,30,2,ORANGE,1996-03-26,ORANGE,0,M,II,Shall the office of City Clerk be appointive?,70,70,Ordinance,42,42,Governance: Personnel/Labor Relations,9091,12018,21109,0.4306693827277465,M,2,Fail,0,199600123,9091,12018,21109,0.43066938272774646,2,Fail,70,40
199600124,1996,30,2,ORANGE,1996-03-26,SAN CLEMENTE,0,M,JJ,"Shall the office of City Treasurer of the City of San Clemente, California, be appointive?",70,70,Ordinance,42,42,Governance: Personnel/Labor Relations,3495,6874,10369,0.33706239753110234,M,2,Fail,0,199600124,3495,6874,10369,0.33706239753110234,2,Fail,70,40
199600125,1996,33,2,RIVERSIDE,1996-03-26,CATHEDRAL CITY,0,M,I,"Shall the City of Cathedral City incur a general obligation bonded indebtedness in the principal sum of not to exceed $5,000,000 for the improvement of real property for parks and sports facilities?",11,11,GO Bond,51,51,Environment: Parks/Recreation,1668,2720,4388,0.38012762078395623,T,2,FailT,0,199600125,1668,2720,4388,0.38012762078395623,2,FailT,10,50
199600126,1996,33,2,RIVERSIDE,1996-03-26,CATHEDRAL CITY,0,M,J,"Shall the City of Cathedral City incur a general obligation bonded indebtedness in the principal sum of not to exceed $2,000,000 for the improvement of real property for a municipal pool and aquatic sports complex?",11,11,GO Bond,51,51,Environment: Parks/Recreation,1474,2906,4380,0.3365296803652968,T,2,FailT,0,199600126,1474,2906,4380,0.3365296803652968,2,FailT,10,50
199600127,1996,33,2,RIVERSIDE,1996-03-26,INDIO,0,M,D,Shall the office of City Treasurer be appointive?,70,70,Ordinance,42,42,Governance: Personnel/Labor Relations,1274,1658,2932,0.4345156889495225,M,2,Fail,0,199600127,1274,1658,2932,0.4345156889495225,2,Fail,70,40
199600128,1996,33,2,RIVERSIDE,1996-03-26,INDIO,0,M,E,Shall the office of City Clerk be appointive?,70,70,Ordinance,42,42,Governance: Personnel/Labor Relations,1290,1617,2907,0.44375644994840047,M,2,Fail,0,199600128,1290,1617,2907,0.4437564499484004,2,Fail,70,40
199600129,1996,33,2,RIVERSIDE,1996-03-26,INDIO,0,M,F,Shall the qualified electors of the City elect a Mayor and four City Councilmembers?,70,70,Ordinance,42,42,Governance: Personnel/Labor Relations,1422,1519,2941,0.48350901054063244,M,2,Fail,0,199600129,1422,1519,2941,0.48350901054063244,2,Fail,70,40
199600130,1996,33,2,RIVERSIDE,1996-03-26,INDIO,0,M,G,Shall the term of office of the directly elected Mayor be two years?,70,70,Ordinance,42,42,Governance: Personnel/Labor Relations,1628,1159,2787,0.584140653031934,M,1,Pass,0,199600130,1628,1159,2787,0.584140653031934,1,Pass,70,40
199600131,1996,33,2,RIVERSIDE,1996-03-26,INDIO,0,M,H,Shall the term for the directly elected Mayor be four years?,70,70,Ordinance,42,42,Governance: Personnel/Labor Relations,791,1920,2711,0.2917742530431575,M,2,Fail,0,199600131,791,1920,2711,0.2917742530431575,2,Fail,70,40
199600132,1996,33,2,RIVERSIDE,1996-03-26,PERRIS,0,R,,Shall JUDITH C. BAITINGER be recalled (removed) from the office of City Council?,50,50,Recall,48,46,Governance: Recall,2069,756,2825,0.7323893805309735,M,1,Pass,0,199600132,2069,756,2825,0.7323893805309735,1,Pass,50,40
199600133,1996,34,2,SACRAMENTO,1996-03-26,FOLSOM,0,M,L,"CHARTER AMENDMENT CONCERNING PROCEDURES FOR ENFORCEMENT OF THE CHARTER OR ANY ORDINANCE.  Shall Section .04 of the Charter of the City of Folsom be amended to read as follows:  ""Section 7.04.  Violations:  The provsions of this Charter or of any ordinance of the City shall be enfoced by any method or procedure provided for by ordinance of the City.  The sanction for a violation of the provisions of this Charter or of any ordinance of the City shall be established by ordinance.""",20,20,Charter Amendment,40,40,Governance,6797,2925,9722,0.6991359802509771,M,1,Pass,0,199600133,6797,2925,9722,0.6991359802509771,1,Pass,20,40
199600134,1996,34,2,SACRAMENTO,1996-03-26,ISLETON,0,R,,Shall RANDALL HELTON be recalled (removed) from the office of Councilmember of the Isleton City Council?,50,50,Recall,48,46,Governance: Recall,217,76,293,0.7406143344709898,M,1,Pass,0,199600134,217,76,293,0.7406143344709898,1,Pass,50,40
199600135,1996,36,2,SAN BERNARDINO,1996-03-26,ADELANTO,0,R,O,Shall JUDITH CROMME BE RECALLED (removed from office of councilperson (Term Ending November 1996)?,50,50,Recall,48,46,Governance: Recall,1413,291,1704,0.829225352112676,M,1,Pass,0,199600135,1413,291,1704,0.829225352112676,1,Pass,50,40
199600136,1996,36,2,SAN BERNARDINO,1996-03-26,ADELANTO,0,R,P,Shall MARY SCARPA BE RECALLED (removed) from office of councilperson (Term Ending November 1998)?,50,50,Recall,48,46,Governance: Recall,1411,284,1695,0.8324483775811209,M,1,Pass,0,199600136,1411,284,1695,0.8324483775811209,1,Pass,50,40
199600137,1996,36,2,SAN BERNARDINO,1996-03-26,ADELANTO,0,R,Q,Shall HAROLD SMITH BE RECALLED (removed) from office of councilperson (Term Ending November 1996)?,50,50,Recall,48,46,Governance: Recall,1396,284,1680,0.830952380952381,M,1,Pass,0,199600137,1396,284,1680,0.830952380952381,1,Pass,50,40
199600138,1996,36,2,SAN BERNARDINO,1996-03-26,LOMA LINDA,0,M,R,"Shall Ordinance No. 495, codified as Chapter 20.12 in the Loma Linda Municipal Code, pertaining to hillside conservation and preservation be amended to redefine the boundaries of the Hillside Conservation Area within the South Hills of Loma Linda, provide a single road connection between Scotch Lane and Oakwood Drive, and provide for the development of one dwelling unit for each pre-existing, non-conforming lot?",70,70,Ordinance,23,23,Land Use: Open Space,1687,899,2586,0.6523588553750966,M,1,Pass,0,199600138,1687,899,2586,0.6523588553750966,1,Pass,70,20
199600139,1996,37,2,SAN DIEGO,1996-03-26,CARLSBAD,0,M,E,Shall the voters of the City of Carlsbad approve the Green Valley Balanced Use and Traffic Control Initiative of 1994?,40,40,Initiative,21,21,Land Use: Growth Cap/Boundary,7907,10582,18489,0.427659689545135,M,2,Fail,0,199600139,7907,10582,18489,0.42765968954513495,2,Fail,40,20
199600140,1996,37,2,SAN DIEGO,1996-03-26,CHULA VISTA,0,M,F,"Shall the Charter be amended to permit anticipated vacancies to be filled by election instead of by appointment where there is a consolidated election occurring between the anticipation of the vacancy and the actual occurrence of the vacancy, and to permit various other changes to the Charter rules regarding vacancies?",20,20,Charter Amendment,48,48,Governance: Elections,17558,6604,24162,0.7266782551113319,M,1,Pass,0,199600140,17558,6604,24162,0.7266782551113319,1,Pass,20,40
199600141,1996,37,2,SAN DIEGO,1996-03-26,LEMON GROVE,0,M,G,ADVISORY VOTE ONLY.  Should the City request that the County levy annual charges not to exceed $1.15 per benefit unit on the property tax roll to fund Lemon Grove's share of the Regional Communications System?,30,30,Advisory,74,73,Facilities: Museum/Cultural/Comm Ctrs,1601,2977,4578,0.34971603320227174,M,2,Fail,0,199600141,1601,2977,4578,0.34971603320227174,2,Fail,30,70
199600142,1996,37,2,SAN DIEGO,1996-03-26,NATIONAL CITY,0,M,H,Shall the office of City Clerk be appointive?,70,70,Ordinance,42,42,Governance: Personnel/Labor Relations,1944,2779,4723,0.4116027948337921,M,2,Fail,0,199600142,1944,2779,4723,0.4116027948337921,2,Fail,70,40
199600143,1996,37,2,SAN DIEGO,1996-03-26,SAN DIEGO,0,M,B,AMENDS THE SAN DIEGO CITY CHARTER.  Shall the San Diego City Charter be amended to add Section 92.1 to authorize short term borrowing to allow the City to take advantage of more favorable short term borrowing rates for City enterprise funds?,20,20,Charter Amendment,40,40,Governance,89195,97456,186651,0.47787046412823936,M,2,Fail,0,199600143,89195,97456,186651,0.47787046412823936,2,Fail,20,40
199600144,1996,37,2,SAN DIEGO,1996-03-26,SAN DIEGO,0,M,C,"AMENDS THE SAN DIEGO PROGRESS GUIDE AND GENERAL PLAN.  Shall the City of San Diego's Progress Guide and General Plan be amended to allow the City Council to approve conditional use permits for two specifically identified hotels an intensified uses in Subareas 1A and V of the North City Future Urbanizing Area, subject to certain conditions which would create benefits to the City, including a stream of funds totaling a maximum of $6.3 million for each hotel to be expended for acquisition of public open space lands?",70,70,Ordinance,22,22,Land Use: Zoning,111458,73410,184868,0.6029058571521302,M,1,Pass,0,199600144,111458,73410,184868,0.6029058571521302,1,Pass,70,20
199600145,1996,37,2,SAN DIEGO,1996-03-26,SAN DIEGO,0,M,D,"AMENDS THE SAN DIEGO PROGRESS GUIDE AND GENERAL PLAN.  Shall the official phased development map in the Progress Guide and General plan of the City of San Diego be amended to make it consistent with the text of the General Plan by changing the designation of the San Diego Navel Training Center, the Marine Corps Recruit Depot Lindbergh Field and Harbor Island from the Future Urbanizing category to the Urbanized category?",70,70,Ordinance,22,22,Land Use: Zoning,127610,58809,186419,0.6845332289090704,M,1,Pass,0,199600145,127610,58809,186419,0.6845332289090704,1,Pass,70,20
199600146,1996,37,2,SAN DIEGO,1996-03-26,VISTA,0,M,J,"Shall the City of Vista proceed to acquire, rehabilitate and/or lease city administrative offices at the Broadway Shopping Center located at 300 West Broadway within the City of Vista at a total capital cost not to exceed $5,000,000.",70,70,Ordinance,70,70,Facilities,8364,4247,12611,0.6632305130441678,M,1,Pass,0,199600146,8364,4247,12611,0.6632305130441678,1,Pass,70,70
199600147,1996,39,2,SAN JOAQUIN,1996-03-26,STOCKTON,0,M,Q,ADOPTION OF ORDINANCE NO. 024-95 C.S. RELATING TO CARD ROOM REGULATIONS.  Shall Ordinance No. 024-95 C.S. relating to card room regulations be adopted?,70,70,Ordinance,200,90,Gambling,11065,22525,33590,0.32941351592735935,M,2,Fail,0,199600147,11065,22525,33590,0.32941351592735935,2,Fail,70,90
199600148,1996,41,2,SAN MATEO,1996-03-26,PACIFICA,0,M,C,"Shall the City Council, at its discretion, and following public hearings, permit review and environmental review, rezone the following parcels of land, legally identified as A.P. Nos. 022-191-070, -080, -110, -230, and -240 from A/B-5CZ (Agricultural Coastal Combining District to SA-4/PD/CZ (Special Area Pacific State Beach Coastal Combining District with a Development Plan) to allow those uses described in the proposed Development Plan as shown and described in the sample ballot pamphlet?",70,70,Ordinance,22,22,Land Use: Zoning,5874,3098,8972,0.654703522068658,M,1,Pass,0,199600148,5874,3098,8972,0.654703522068658,1,Pass,70,20
199600149,1996,43,2,SANTA CLARA,1996-03-26,LOS GATOS,0,M,C,Shall the ordinance amending the Town Code to impose a two percent (2%) utility users tax on users of specified utility services within the Town of Los Gatos for a period of five (5) years be adopted?,5,5,Utility Tax,100,112,Revenues: Tax Creation/Incr./Contin.,3308,5521,8829,0.3746743685581606,M,2,Fail,0,199600149,3308,5521,8829,0.3746743685581606,2,Fail,1,110
199600150,1996,43,2,SANTA CLARA,1996-03-26,MILPITAS,0,M,F,"Should the City of Milpitas enact an ordinance providing a person cannot serve more than three consecutive terms as a Councilmember or Mayor, except that, if a Councilmember is elected Mayor or the Mayor is elected Councilmember, that person may serve a combined total of no more than four consecutive terms?",70,70,Ordinance,45,49,Governance: Political Reform/Term Limits,5134,1989,7123,0.720763723150358,M,1,Pass,0,199600150,5134,1989,7123,0.720763723150358,1,Pass,70,40
199600151,1996,43,2,SANTA CLARA,1996-03-26,MORGAN HILL,0,M,D,Shall the electors elect a mayor and four city councilmembers?,70,70,Ordinance,48,48,Governance: Elections,4140,1418,5558,0.7448722562072689,M,1,Pass,0,199600151,4140,1418,5558,0.7448722562072688,1,Pass,70,40
199600152,1996,43,2,SANTA CLARA,1996-03-26,MORGAN HILL,0,M,E,Shall the term of office for mayor be two years or four years ?      Two years                                                                                                        Four years,70,70,Ordinance,42,42,Governance: Personnel/Labor Relations,3570,1820,5390,0.6623376623376623,M,1,Pass,0,199600152,3570,1820,5390,0.6623376623376623,1,Pass,70,40
199600153,1996,43,2,SANTA CLARA,1996-03-26,SAN JOSE,0,M,B,CHARTER AMENDMENT-MUNICIPAL ELECTIONS.  Amends City Charter Section 1600 to require that Regular Municipal Primary and Run-off Elections be held on the same date that the State of California holds it Direct Primary and Run-off Elections.,20,20,Charter Amendment,48,48,Governance: Elections,107173,12117,119290,0.8984240087182497,M,1,Pass,0,199600153,107173,12117,119290,0.8984240087182497,1,Pass,20,40
199600154,1996,43,2,SANTA CLARA,1996-03-26,SARATOGA,0,M,G,"Do the qualified electors of the City of Saratoga approve the following proposed initiative petition?Amendment of the City General Plan requiring vote of the people in order to intensify existing land use designations for all lands designated ""Residential"" or ""Outdoor Recreation.""",40,40,Initiative,22,22,Land Use: Zoning,5768,4865,10633,0.5424621461487821,M,1,Pass,0,199600154,5768,4865,10633,0.5424621461487821,1,Pass,40,20
199600155,1996,47,2,SISKIYOU,1996-03-26,DUNSMUIR,0,M,A,Shall the Office of City Clerk be appointive?,70,70,Ordinance,42,42,Governance: Personnel/Labor Relations,217,415,632,0.34335443037974683,M,2,Fail,0,199600155,217,415,632,0.34335443037974683,2,Fail,70,40
199600156,1996,47,2,SISKIYOU,1996-03-26,DUNSMUIR,0,M,B,Shall the Office of City Treasurer be appointive?,70,70,Ordinance,42,42,Governance: Personnel/Labor Relations,214,415,629,0.34022257551669316,M,2,Fail,0,199600156,214,415,629,0.34022257551669316,2,Fail,70,40
199600157,1996,48,2,SOLANO,1996-03-26,BENICIA,0,M,A,"Shall an Ordinance authorizing the continued imposition of a four percent (4%) utility users' excise tax upon the use of telephone, cable television, gas and electricity services be adopted?",5,5,Utility Tax,100,112,Revenues: Tax Creation/Incr./Contin.,5755,2484,8239,0.6985071003762593,M,1,Pass,0,199600157,5755,2484,8239,0.6985071003762593,1,Pass,1,110
199600158,1996,48,2,SOLANO,1996-03-26,BENICIA,0,M,B,Shall an Ordinance authorizing the continued imposition of a 9 percent (9%) transient occupancy tax on the occupancy of hotel and motel rooms be adopted?,2,2,Business Tax,100,112,Revenues: Tax Creation/Incr./Contin.,6190,2022,8212,0.7537749634680955,M,1,Pass,0,199600158,6190,2022,8212,0.7537749634680955,1,Pass,1,110
199600159,1996,48,2,SOLANO,1996-03-26,DIXON,0,M,A,"Shall an ordinance be adopted establishing a parcel tax, not to exceed $128 per parcel not to extend beyond December 31, 2001?",3,3,Property Tax,200,112,Revenues: Tax Creation/Incr./Contin.,867,2159,3026,0.28651685393258425,T,2,FailT,0,199600159,867,2159,3026,0.28651685393258425,2,FailT,1,110
199600160,1996,49,2,SONOMA,1996-03-26,SANTA ROSA,0,M,A,"Shall the electorate of the City of Santa Rosa amend the Charter of the City of Santa Rosa to add Section 58 pertaining to binding arbitration of disputes and controversies on wages, hours, and terms and conditions of employmemt between the City of Santa Rosa and the City's employee units within the fire and police departments?",20,20,Charter Amendment,41,41,Governance: Benefits/Compensation,18426,16138,34564,0.533098021062377,M,1,Pass,0,199600160,18426,16138,34564,0.533098021062377,1,Pass,20,40
199600161,1996,50,2,STANISLAUS,1996-03-26,TURLOCK,0,M,H,"Shall an Ordinance of the City of Turlock be enacted to continue the City Council's policy of imposing a 4% utility users tax on electricity, gas, telephone and cable television services to provide additional general fund revenue to support the expansion of public safety staffing and public safety services?",5,5,Utility Tax,30,30,Safety,2989,5311,8300,0.36012048192771084,M,2,Fail,0,199600161,2989,5311,8300,0.36012048192771084,2,Fail,1,30
199600162,1996,50,2,STANISLAUS,1996-03-26,TURLOCK,0,M,I,Shall the 1988 Business License Ordinance be revised to impose a new tax rate which will equalize the basis of payment for all business and provide additional general fund revenue for the expansion of public safety staffing and public safety services?,2,2,Business Tax,30,30,Safety,4163,4001,8164,0.509921607055365,M,1,Pass,0,199600162,4163,4001,8164,0.509921607055365,1,Pass,1,30
199600163,1996,54,2,TULARE,1996-03-26,FARMERSVILLE,0,R,1,Shall PAUL BOYER be recalled (removed) from the office of City Council?,50,50,Recall,48,46,Governance: Recall,291,193,484,0.6012396694214877,M,1,Pass,0,199600163,291,193,484,0.6012396694214877,1,Pass,50,40
199600164,1996,54,2,TULARE,1996-03-26,FARMERSVILLE,0,R,2,Shall DENNIS JOHNSON be recalled (removed) from the office of City Council?,50,50,Recall,48,46,Governance: Recall,288,189,477,0.6037735849056604,M,1,Pass,0,199600164,288,189,477,0.6037735849056604,1,Pass,50,40
199600165,1996,1,3,ALAMEDA,1996-03-26,PIEDMONT UNIFIED SCHOOL DISTRICT,0,M,B,"Shall the Piedmont City Unified School District issue bonds for the purpose of completing improvements to school facilities to accommodate increased enrollment, to address curriculum needs and to replace or upgrade temporary and obsolete facilities, including classrooms, libraries, student services spaces and remodeling at school sites, improvements to physical education and athletic facilities, and improvement of handicapped access in a total amount not to exceed $4,500,000?",11,11,GO Bond,11,11,Education: Bonds,3250,808,4058,0.8008871365204534,T,1,PassT,0,199600165,3250,808,4058,0.8008871365204534,1,PassT,10,10
199600166,1996,1,3,ALAMEDA,1996-03-26,PLEASANTON UNIFIED SCHOOL DISTRICT,0,M,A,"Shall the Pleasanton Unified School District provide funds for a District-wide class size reduction by levying a qualified special tax of two hundred and four dollars ($204) per year per assessor=s parcel, increasing annually two percent per year, excluding property exempted by law, owned by citizens over 65 years of age or over who apply for such exemption, and Governing Board Resolution, for a period of five years, beginning July 1, 1996 and ending June 30, 2001?  Shall the State Appropriations Limit be increased accordingly?",3,3,Property Tax,12,12,Education: Districts,7329,8737,16066,0.45618075438814887,T,2,FailT,0,199600166,7329,8737,16066,0.45618075438814887,2,FailT,1,10
199600167,1996,1,3,ALAMEDA,1996-03-26,TRACY JOINT UNION HIGH SCHOOL DISTRICT,0,M,P,"Shall the Tracy Joint Union High School District and Tracy School District be unified to form the Tracy Unified School District with a seven member board elected at large pursuant to Education Code section 5003(a) while permitting the Banta Elementary School District, the Holt Union Elementary School District, the Jefferson Elementary School District, the Lammersville Elementary School District, the Mountain House Elementary School District, and the New Jerusalem Elementary School District, which currently feed into the Tracy Joint Union High School District, to continue to exist as independent elementary school district?",70,70,Ordinance,12,12,Education: Districts,32,6,38,0.8421052631578947,M,1,Pass,1,199600175,8303,1217,9520,0.8721638655462185,1,Pass,70,10
199600168,1996,5,3,CALAVERAS,1996-03-26,CALAVERAS UNIFIED SCHOOL DISTRICT,0,M,C,"Shall the Calaveras Unified School District incur a bonded indebtedness of not to exceed $22,300,000 with an interest rate not to exceed the maximum rate allowable by law, to be used for the construction, expansion and modernization of classroom and school facilities?",11,11,GO Bond,11,11,Education: Bonds,3618,3418,7036,0.5142126208072768,T,2,FailT,0,199600167,3618,3418,7036,0.5142126208072768,2,FailT,10,10
199600169,1996,10,3,FRESNO,1996-03-26,CLOVIS UNIFIED SCHOOL DISTRICT,0,M,A,"To reduce overcrowding, upgrade safety systems and enhance technology capabilities, shall Clovis USD increase technology and improve security systems and outdoor safety lighting at all existing facilities; Expand library/media centers; Renovate existing facilities; Construct the central Clovis elementary school; Construct a new intermediate and high school; Acquire sites and construct new school and District facilities; and issue bonds up to $98 million at an interest rate of 12% or less to accomplish the above.",11,11,GO Bond,11,11,Education: Bonds,23463,11625,35088,0.668,T,1,PassT,0,199600168,23463,11625,35088,0.6686901504787962,1,PassT,10,10
199600170,1996,18,3,LASSEN,1996-03-26,RICHMOND ELEMENTARY SCHOOL DISTRICT,0,M,A,"In order to construct a multi-purpose room and other school facilities, shall the Richmond Elementary School District incur bonded indebtedness in the principal amount of not to exceed $649,000 with an interest rate not to exceed the statutory maximum?",11,11,GO Bond,11,11,Education: Bonds,353,159,512,0.689453125,T,1,PassT,0,199600169,353,159,512,0.689453125,1,PassT,10,10
199600171,1996,18,3,LASSEN,1996-03-26,WESTWOOD UNIFIED SCHOOL DISTRICT,0,M,B,"In order to install electrical wiring to accommodate computers, meet vocational instruction and technology needs, and replace inefficient heating systems at both Fletcher Walker Elementary School and Westwood High School, build a library and music room at Westwood High School, and to do other necessary construction or modernization of school facilities, shall the Westwood Unified School District incur bonded indebtedness in the principal amount of $1,200,000 with an interest rate not to exceed the statutory maximum?",11,11,GO Bond,11,11,Education: Bonds,484,205,689,0.7024673439767779,T,1,PassT,0,199600170,484,205,689,0.7024673439767779,1,PassT,10,10
199600172,1996,29,3,NEVADA,1996-03-26,NEVADA BOARD OF EDUCATION,0,M,A,For decreasing the number of members of the County Board of Education from seven to five.,70,70,Ordinance,12,12,Education: Districts,22189,5565,27754,0.7994883620379044,M,1,Pass,0,199600171,22189,5565,27754,0.7994883620379044,1,Pass,70,10
199600173,1996,34,3,SACRAMENTO,1996-03-26,FOLSOM CORDOVA UNIFIED - PROPOSED,0,M,O,PROPOSED UNIFIED SCHOOL DISTRICT.  Shall a unified school district be formed along the boundaries of the City of Folsom including those protions of the Folsom Cordova Unified School District and the San Juan Unified School District of Sacramento County?,70,70,Ordinance,12,12,Education: Districts,8363,13410,21773,0.3840995728654756,M,2,Fail,0,199600172,8363,13410,21773,0.3840995728654756,2,Fail,70,10
199600174,1996,36,3,SAN BERNARDINO,1996-03-26,GRAND TERRACE UNIFIED SCHOOL DISTRICT - PROPOSED,0,M,N,"Shall the proposed Grand Terrace territory, currently in the Colton Joint Unified School District be formed in to Grand Terrace Unified School District?",70,70,Ordinance,12,12,Education: Districts,1592,1841,3433,0.4637343431401107,M,2,Fail,0,199600173,1592,1841,3433,0.4637343431401107,2,Fail,70,10
199600175,1996,37,3,SAN DIEGO,1996-03-26,ENCINITAS UNION SCHOOL DISTRICT,0,M,O,"To provide classrooms, school repairs and safety improvements, including roofs, lighting, plumbing, electrical, heating and ventilation systems; to provide access to modern technology; to purchase, construct, improve and renovate buildings and grounds for public school purposes; and to finance require sewage and drainage projects or purposes specifically authorized by law, shall the Encinitas Union School District be authorized to issue up to $29,500,000 in bonds, to bear interest at rates not to exceed the maximum set by law?",11,11,GO Bond,11,11,Education: Bonds,12604,3827,16431,0.7670866045888869,T,1,PassT,0,199600174,12604,3827,16431,0.7670866045888869,1,PassT,10,10
199600176,1996,39,3,SAN JOAQUIN,1996-03-26,TRACY JOINT UNION HIGH SCHOOL DISTRICT,0,M,P,"Shall the Tracy Joint Union High School District and Tracy School District be unified to form the Tracy Unified School District with a seven member board elected at large pursuant to Education Code section 5003(a) while permitting the Banta Elementary School District, the Delta Island Union Elementary School District, the Holt Union Elementary School District, the Jefferson Elementary School District, the Lammersville Elementary School District, the Mountain House Elementary School District and the New Jerusalem Elementary School District, which currently feed in to the Tracy Joint Union High School District, to continue to exist as independent elementary school districts?",70,70,Ordinance,12,12,Education: Districts,8271,1211,9482,0.8722843282008015,M,1,Pass,1,199600175,8303,1217,9520,0.8721638655462185,1,Pass,70,10
199600177,1996,41,3,SAN MATEO,1996-03-26,SAN BRUNO PARK ELEMENTARY SCHOOL DISTRICT,0,M,B,"For the exclusive purpose of funding seismic improvements for classrooms and school facilities, shall the San Bruno Park School District issue bonds in an amount of $600,000, with an interest rate not to exceed the statutory limit?",11,11,GO Bond,11,11,Education: Bonds,4328,1506,5834,0.7418580733630442,T,1,PassT,0,199600176,4328,1506,5834,0.7418580733630442,1,PassT,10,10
199600178,1996,52,3,TEHAMA,1996-03-26,ORLAND JOINT UNION HIGH SCHOOL DISTRICT,0,M,D,Shall a unified school District be formed between Orland Joint Union High School and the Orland Joint Union School District excluding the school districts of Lake and Plaza?,70,70,Ordinance,12,12,Education: Districts,6,8,14,0.42857142857142855,M,2,Fail,0,199600177,6,8,14,0.42857142857142855,2,Fail,70,10
199600179,1996,47,2,SISKIYOU,1996-04-09,DORRIS,0,M,A,Shall the City of Dorris retain the Dorris Police Department?,70,70,Ordinance,32,32,Safety: Police,129,146,275,0.46909090909090917,M,2,Fail,0,199600178,129,146,275,0.4690909090909091,2,Fail,70,30
199600180,1996,47,2,SISKIYOU,1996-04-09,DORRIS,0,M,B,Shall the City of Dorris contract with the Siskiyou County Sheriff's Office?,70,70,Ordinance,32,32,Safety: Police,160,107,267,0.599250936329588,M,1,Pass,0,199600179,160,107,267,0.599250936329588,1,Pass,70,30
199600181,1996,27,3,MONTEREY,1996-04-09,GONZALES UNION HIGH SCHOOL DISTRICT,0,M,A,"Shall the territory of Gonzales Union High School District be unified, excluding the territory within the Soledad Unified School District and allowing Chualar Union Elementary School District and Mission Union Elementary School District to remain independent elementary school districts within the Gonzeles Unified School District for the purpose of K-8 instruction for the residents within the boundaries of those districts and be d\governed by a five (5) member board of trustees elected district-wide?",70,70,Ordinance,12,12,Education: Districts,574,94,668,0.8592814371257486,M,1,Pass,0,199600180,574,94,668,0.8592814371257484,1,Pass,70,10
199600182,1996,41,2,SAN MATEO,1996-05-14,COLMA,0,M,A,"If a cardroom is allowed in the Town of Colma, should it be taxed on its gross receipts (other than receipts from food and beverage sales) on a graduated basis beginning at 5% of such revenues up to $800,000 per year and rising to 20% of such revenues over $3,000,000 per year, and the revenues deposited to the city's general fund, as set forth in Colma Municipal Code section 4.943?",2,2,Business Tax,100,112,Revenues: Tax Creation/Incr./Contin.,327,30,357,0.9159663865546219,M,1,Pass,0,199600181,327,30,357,0.9159663865546218,1,Pass,1,110
199600183,1996,41,2,SAN MATEO,1996-05-14,COLMA,0,M,B,"Shall the ordinance that would ban the construction, operation or use of a gaming club or cardroom in the Town of Colma by amending the zoning ordinance (Colma Municipal Code, Section 5.101 et seq.) to that effect, repealing Measure A, adopted February 9, 1993 (which had authorized cardrooms in Colma), and amending the cardroom ordinance (Colma Municipal Code, Section 4.901 et seq.) to require approval of the voters before any cardroom is authorized - be adopted?",70,70,Ordinance,24,24,Land Use: Private Projects,166,199,365,0.4547945205479452,M,2,Fail,0,199600182,166,199,365,0.4547945205479452,2,Fail,70,20
199600184,1996,13,2,IMPERIAL,1996-06-04,CALEXICO,0,M,B,"Shall the electors of the City of Calexico approve the continuance of the five percent utility users' tax after August 1, 1996, in order to maintain city general government services, including but not limited to, police, fire emergency, administrative, library, parts and recreation, (as set forth in ordinance No. 922) upon the following utility services:  defined telephone, electrical, gas and cable television?",5,5,Utility Tax,100,112,Revenues: Tax Creation/Incr./Contin.,529,851,1380,0.38333333333333336,M,2,Fail,0,199600183,529,851,1380,0.38333333333333336,2,Fail,1,110
199600185,1996,13,2,IMPERIAL,1996-06-04,EL CENTRO,0,M,A,"Shall the electors of the City of El Centro approve the continuance of the four percent utility users tax after August 1, 1996 in order to maintain city general government services, including, but not limited to, police, fire emergency, administrative, library, parks and recreation, as set forth in Ordinance Nos. 95-9 and 96-2) upon the following utility services:  defined telephone, electrical, gas, cable television, water, sewage disposal, and garbage, rubbish and other refuse removal.?",5,5,Utility Tax,100,112,Revenues: Tax Creation/Incr./Contin.,1401,2660,4061,0.34498891898547157,M,2,Fail,0,199600184,1401,2660,4061,0.34498891898547157,2,Fail,1,110
199600186,1996,13,2,IMPERIAL,1996-06-04,HOLTVILLE,0,M,C,"Shall the electors of the City of Holtville approve the continuance of the five percent utility tax after August 1, 196 in order to maintain city General government services, including, but not limited to, police, fire emergency, administrative, parks and recreation, (as set forth in Ordinance Nos. 415 and 422)?",5,5,Utility Tax,100,112,Revenues: Tax Creation/Incr./Contin.,351,322,673,0.5215453194650818,M,1,Pass,0,199600185,351,322,673,0.5215453194650818,1,Pass,1,110
199600187,1996,27,2,MONTEREY,1996-06-04,MARINA,0,M,A,Shall the five percent (5%) Utility User's Tax imposed by Chapter 3.14 of the Municipal Code be extended for a period of two (2) years?,5,5,Utility Tax,100,112,Revenues: Tax Creation/Incr./Contin.,818,567,1385,0.5906137184115523,M,1,Pass,0,199600186,818,567,1385,0.5906137184115523,1,Pass,1,110
199600188,1996,33,2,RIVERSIDE,1996-06-04,MORENO VALLEY,0,M,O,"Shall the ordinance entitled: ""AN ORDINANCE OF THE CITY COUNCIL OF THE CITY OF MORENO VALLEY, CALIFORNIA, ENACTING A UTILITY USERS TAX AND REPEALING AND RE-ENACTING CHAPTER 3.26 OF THE CITY OF MORENO VALLEY MUNICIPAL CODE, RELATING TO SUCH TAX"" be approved?",5,5,Utility Tax,100,112,Revenues: Tax Creation/Incr./Contin.,4881,5223,10104,0.4830760095011877,M,2,Fail,0,199600187,4881,5223,10104,0.4830760095011877,2,Fail,1,110
199600189,1996,33,2,RIVERSIDE,1996-06-04,MORENO VALLEY,0,M,P,"Shall the ordinance entitled: ""AN ORDINANCE OF THE CITY COUNCIL OF THE CITY OF MORENO VALLEY, CALIFORNIA, ENACTING A BUSINESS LICENSE TAX AND REPEALING AND RE-ENACTING CHAPTER 5.02 OF THE CITY OF MORENO VALLEY MUNICIPAL CODE, RELATING TO BUSINESS LICENSES"" be approved?",2,2,Business Tax,100,112,Revenues: Tax Creation/Incr./Contin.,4932,5152,10084,0.48909163030543434,M,2,Fail,0,199600188,4932,5152,10084,0.48909163030543434,2,Fail,1,110
199600190,1996,33,2,RIVERSIDE,1996-06-04,MURRIETA,0,M,N,"Shall Resolution 96-410, A Resolution of the City Council of the City of Murrieta Approving the Copper Canyon Specific Plan SPM-7 and Attaching Conditions of Approval Thereto, be Adopted?",70,70,Ordinance,22,22,Land Use: Zoning,3308,2345,5653,0.5851760127366,M,1,Pass,0,199600189,3308,2345,5653,0.5851760127366,1,Pass,70,20
199600191,1996,41,2,SAN MATEO,1996-06-04,DALY CITY,0,M,B,Shall the office of city clerk be appointive?,70,70,Ordinance,42,42,Governance: Personnel/Labor Relations,872,2576,3448,0.2529002320185615,M,2,Fail,0,199600190,872,2576,3448,0.2529002320185615,2,Fail,70,40
199600192,1996,41,2,SAN MATEO,1996-06-04,SAN CARLOS,0,M,A,"In order to provide for improved library services to the citizens of San Carlos, including the provision of educational and computer technology, meeting space for community functions, and on site parking, shall the City of San Carlos issue general obligation bonds in an amount not to exceed  $8,000,000 for the purpose of acquiring, constructing, and completing a new public library.",11,11,GO Bond,71,71,Facilities: Libraries,4258,1236,5494,0.7750273025118312,T,1,PassT,0,199600191,4258,1236,5494,0.775027302511831,1,PassT,10,70
199600193,1996,1,3,ALAMEDA,1996-06-04,NEW HAVEN UNIFIED SCHOOL DISTRICT,0,M,A,"To improve the learning environment and relieve overcrowding in our schools, shall New Haven USD incur $35 million bonded indebtedness at interest rates not exceeding the legal limit for 1) building an elementary school to reduce overcrowding in the middle schools and return fifth graders to elementary schools 2) building classrooms and reconfiguring the Logan High campus into smaller learning sites 3) modernizing classrooms for science, technology, and other programs for the 21st century 4) acquiring and constructing necessary facilities?",11,11,GO Bond,11,11,Education: Bonds,2667,1098,3765,0.7083665338645418,T,1,PassT,0,199600192,2667,1098,3765,0.7083665338645418,1,PassT,10,10
199600194,1996,11,3,GLENN,1996-06-04,HAMILTON UNION ELEMENTARY SCHOOL DISTRICT,0,M,E,"In order to relieve overcrowding and provide additional community facilities by financing the acquisition and development of land on Sacramento Avenue and the acquisition and construction of buildings for school purposes, including construction of a multipurpose room and classrooms; purchase of relocatable school buildings; and for necessary related sewage and drainage projects as authorized by law, shall the Hamilton Union Elementary School District be authorized to issue $1,100,000 of bonds bearing interest at rates not exceeding the statutory limit?",11,11,GO Bond,11,11,Education: Bonds,124,93,217,0.5714285714285714,T,2,FailT,0,199600193,124,93,217,0.5714285714285714,2,FailT,10,10
199600195,1996,19,3,LOS ANGELES,1996-06-04,BALDWIN PARK UNIFIED SCHOOL DISTRICT,0,M,B,"To bring school facilities into compliance with new earthquake safety and building codes, repair and renovate school facilities, install and upgrade wiring to provide our students with computers and technology, which will provide out students with a better education and job opportunities, shall the Baldwin Park Unified School District be authorized to issue bonds in the amount of $15,000,000, with an interest rate not to exceed the maximum permitted by law?",11,11,GO Bond,11,11,Education: Bonds,1025,378,1403,0.7305773342836779,T,1,PassT,0,199600194,1025,378,1403,0.7305773342836779,1,PassT,10,10
199600196,1996,19,3,LOS ANGELES,1996-06-04,DOWNEY UNIFIED SCHOOL DISTRICT,0,M,D,"Shall the Downey Unified School District incur bonded indebtedness in an amount not to exceed $27.5 million with an interest rate not to exceed the maximum rate allowed by law in order to repair and rehabilitate schools built over 35 years ago including the repair and replacement of existing plumbing and wiring, to construct new classrooms and to provide for computer, science and technology laboratories at each school throughout the District so long as no bond monies are used for administrative salaries?",11,11,GO Bond,11,11,Education: Bonds,5256,1819,7075,0.7428975265017668,T,1,PassT,0,199600195,5256,1819,7075,0.7428975265017668,1,PassT,10,10
199600197,1996,19,3,LOS ANGELES,1996-06-04,PALMDALE SCHOOL DISTRICT,0,M,A,"Shall the Palmdale School District be authorized to issue bonds in the maximum amount not to exceed $81 million at a rate not to exceed the statutory maximum to acquire, construct, modernize and expand school facilities to reduce overcrowding, to add permanent classrooms throughout the district, to upgrade fire alarm systems, to provide required handicap access and to provide students with access to computer technology?",11,11,GO Bond,11,11,Education: Bonds,3030,1607,4637,0.6534397239594566,T,2,FailT,0,199600196,3030,1607,4637,0.6534397239594566,2,FailT,10,10
199600198,1996,19,3,LOS ANGELES,1996-06-04,SAN MARINO UNIFIED SCHOOL DISTRICT,0,M,R,"Shall the San Marino Unified School District be authorized to finance the repair, renovation and construction of District facilities, including safety and seismic upgrades, and repair roofs, plumbing, sewer, lighting and electrical systems; construct and renovate classrooms,; and repair, upgrade and construct science laboratories and libraries by issuing general obligation bonds in the maximum principal amount of $34,330,000 with interest rates not to exceed the maximum set by law?",11,11,GO Bond,11,11,Education: Bonds,3308,1031,4339,0.7623876469232542,T,1,PassT,0,199600197,3308,1031,4339,0.7623876469232542,1,PassT,10,10
199600199,1996,21,3,MARIN,1996-06-04,KENTFIELD SCHOOL DISTRICT,0,M,B,"Shall the Kentfield School District provide funds to continue specific educational programs and services by levying a special assessment for a period of 7 years, beginning July 1, 1996, at the rate of $295 per assessor's parcel, which in tax year 1996-1997 would supplement the presently authorized assessment of $167 per assessor's parcel by $28, and each year increase the prior year's rate of 5% during the assessment period, with an exemption for any beneficial owner of a parcel who has attained the age of 65 on or before July 1 of any assessment year and who uses that parcel as his or her principal place of residence, and continue senior exemptions granted during the term of the current special assessment?",3,3,Property Tax,12,12,Education: Districts,2247,639,2886,0.7785862785862786,T,1,PassT,0,199600198,2247,639,2886,0.7785862785862786,1,PassT,1,10
199600200,1996,28,3,NAPA,1996-06-04,NAPA VALLEY UNIFIED SCHOOL DISTRICT,0,M,Y,"To improve student health and safety conditions by repairing and renovating electrical, plumbing heating and roofing systems; and providing instructional technology infrastructure (cabling, wiring, and conduit) in classrooms, and providing handicapped accessibility as required by law; shall the Napa Valley Unified School District issue $23,100,000 of bonds at an interest rate not exceeding the legal limit, to acquire replacement portable classrooms, and to repair and renovate classrooms and school facilities?",11,11,GO Bond,11,11,Education: Bonds,11844,4691,16535,0.7162987602056246,T,1,PassT,0,199600199,11844,4691,16535,0.7162987602056244,1,PassT,10,10
199600201,1996,33,3,RIVERSIDE,1996-06-04,LAKE ELSINOR UNIFIED SCHOOL DISTRICT,0,M,L,"To construct classrooms and school facilities to relieve overcrowding, shall the Lake Elsinore Unified School District issue bonds of School Facilities Improvement District No. 96-1 in the principal amount of $19,600,000 with an interest rate not to exceed the maximum permitted by law, for purposes which include the construction of new classrooms at Temescal Canyon High School?",11,11,GO Bond,11,11,Education: Bonds,5024,2587,7611,0.6600972276967548,T,2,FailT,0,199600200,5024,2587,7611,0.6600972276967547,2,FailT,10,10
199600202,1996,33,3,RIVERSIDE,1996-06-04,MURRIETA VALLEY UNIFIED SCHOOL DISTRICT,0,M,C,"In order to construct educational facilities including permanent classrooms and computer and science labs and o purchase property for school sites, shall the Murrieta Valley Unified School District incur bonded indebtedness in the amount not to exceed $42,300,000 with an interest rate not to exceed the maximum rate allowed by law?",11,11,GO Bond,11,11,Education: Bonds,4145,2607,6752,0.6138921800947867,T,2,FailT,0,199600201,4145,2607,6752,0.6138921800947867,2,FailT,10,10
199600203,1996,33,3,RIVERSIDE,1996-06-04,SAN JACINTO UNIFIED SCHOOL DISTRICT,0,M,M,"Shall the San Jacinto Unified School District be authorized to issue bonds in the maximum amount not to exceed Thirteen Million Six Hundred Eighty-Five Thousand Dollars ($13,685,000) at a rate not to exceed the statutory maximum to construct, modernize, and repair school facilities to reduce overcrowding, to provide students with access to computer technology; to provide required handicapped access; to install security systems; and to become eligible to receive state matching funds?",11,11,GO Bond,11,11,Education: Bonds,1550,1198,2748,0.5640465793304221,T,2,FailT,0,199600202,1550,1198,2748,0.5640465793304221,2,FailT,10,10
199600204,1996,37,3,SAN DIEGO,1996-06-04,ESCONDIDO UNION HIGH SCHOOL DISTRICT,0,M,A,"$42,976,000 School Improvement Bond.",11,11,GO Bond,11,11,Education: Bonds,15958,6369,22327,0.7147400008957765,T,1,PassT,0,199600203,15958,6369,22327,0.7147400008957764,1,PassT,10,10
199600205,1996,37,3,SAN DIEGO,1996-06-04,SAN MARCOS UNIFIED SCHOOL DISTRICT,0,M,B,"$21,850,000 School Improvement Bond.",11,11,GO Bond,11,11,Education: Bonds,6042,2522,8564,0.7055114432508174,T,1,PassT,0,199600204,6042,2522,8564,0.7055114432508174,1,PassT,10,10
199600206,1996,41,3,SAN MATEO,1996-06-04,CABRILLO UNIFIED SCHOOL DISTRICT,0,M,K,"To repair or replace leaky roofs, deteriorating plumbing, sewers, heating, and electrical systems, expand the high school, construct a new middle school to relieve existing overcrowded conditions and provide adequate classrooms for students already enrolled in district elementary schools, renovate libraries, upgrade science and computer labs, remove harmful asbestos, acquire and construct classrooms and school sites shall Cabrillo Unified School District issue $35 million of bonds at an interest rate within the legal limit?",11,11,GO Bond,11,11,Education: Bonds,4004,1314,5318,0.752914629559985,T,1,PassT,0,199600205,4004,1314,5318,0.752914629559985,1,PassT,10,10
199600207,1996,43,3,SANTA CLARA,1996-06-04,FRANKLIN-MCKINLEY SCHOOL DISTRICT,0,M,E,"To relieve classroom overcrowding, renovate classrooms and provide safe, modern school buildings for our students, shall the Franklin-McKinley School District issue $18,300,000 of bonds at an interest rate within the legal limit, to repair, acquire and construct local classrooms and school sites and facilities?",11,11,GO Bond,11,11,Education: Bonds,1054,440,1494,0.7054886211512718,T,1,PassT,0,199600206,1054,440,1494,0.7054886211512718,1,PassT,10,10
199600208,1996,43,3,SANTA CLARA,1996-06-04,LOMA PRIETA JT. UNION ELEMENTARY SCHOOL DIST.,0,M,D,"Shall the Loma Prieta Joint Union Elementary School District be authorized to implement a special tax of $150 per parcel for each year beginning July 1, 1996 and increase its Gann Appropriations Limit for a period of four years by the amount of revenue generated by that ongoing tax?  Revenue generated from the tax may only be spent if the qualified voters approve an increase in the district's appropriations limit every four years.",60,60,Gann Limit,12,12,Education: Districts,114,40,154,0.7402597402597403,T,1,PassT,0,199600207,114,40,154,0.7402597402597403,1,PassT,60,10
199600209,1996,43,3,SANTA CLARA,1996-06-04,MILPITAS UNIFIED SCHOOL DISTRICT,0,M,B,"To improve the quality of education for Milpitas children, shall the Milpitas Unified School District be authorized to finance the construction, improvement, acquisition and renovation of school facilities to accommodate increasing enrollment; including providing for safety and seismic upgrades; replacement of deteriorated roofs, plumbing, sewer, lighting and electrical systems; renovation of classrooms, and outdated science laboratories and libraries; and providing for technological improvements, by issuing up to $64,700,000 of bonds bearing interest at rates within the statutory maximum?",11,11,GO Bond,11,11,Education: Bonds,4525,997,5522,0.8194494748279609,T,1,PassT,0,199600208,4525,997,5522,0.8194494748279609,1,PassT,10,10
199600210,1996,43,3,SANTA CLARA,1996-06-04,SUNNYVALE ELEMENTARY SCHOOL DISTRICT,0,M,A,"To improve health and safety conditions by the repair and renovation of neighborhood schools, including replacing deteriorating electrical, heating, and plumbing systems, complying with current fire and safety standards and reducing danger from earthquakes with seismic upgrades and to enhance educational opportunities, shall the Sunnyvale Elementary School District issue $34 million of bonds, at an interest rate within the legal limit, to acquire, repair, rehabilitate, construct, and modernize classrooms and school facilities?",11,11,GO Bond,11,11,Education: Bonds,6187,1090,7277,0.8502129998625807,T,1,PassT,0,199600209,6187,1090,7277,0.8502129998625807,1,PassT,10,10
199600211,1996,43,3,SANTA CLARA,1996-06-04,WHISMAN SCHOOL DISTRICT,0,M,C,"Shall the Whisman School District be authorized to finance the repair, renovation and upgrading of existing neighborhood elementary and middle schools, including safety upgrades to reduce danger from earthquakes, repair of leaky roofs, upgrades to inadequate and unsafe electrical, heating and plumbing systems, construction of additional facilities, and renovation of classrooms, school libraries and computer rooms, by issuing bonds in the maximum principal amount of Thirty-Four Million Dollars, with an interest rate not to exceed the limit set by law?",11,11,GO Bond,11,11,Education: Bonds,1459,353,1812,0.8051876379690949,T,1,PassT,0,199600210,1459,353,1812,0.8051876379690949,1,PassT,10,10
199600212,1996,45,3,SHASTA,1996-06-04,COTTONWOOD UNION SCHOOL DISTRICT,0,M,A,"Shall the Cottonwood Elementary School District issue bonds in the principal amount of $4.64 million, with interest not to exceed the maximum amount permitted by law for the purpose of :  Construction of a new elementary school on Gas Point Road; and Renovate inadequate restroom facilities for the Physical Education program at West Cottonwood School?",11,11,GO Bond,11,11,Education: Bonds,938,483,1421,0.6600985221674877,T,2,FailT,0,199600211,938,483,1421,0.6600985221674877,2,FailT,10,10
199600213,1996,45,3,SHASTA,1996-06-04,GRANT SCHOOL DISTRICT,0,M,B,"Shall Grant Elementary School District of Shasta County incur a bonded indebtedness of $10,000 with an interest rate not to exceed the statutory limit to raise money for the following purposes:  (a) the purchasing of school lots; (b) the building or purchasing of school buildings; (c) the making of alterations or additions to the school building or buildings other than as may be necessary for current maintenance, operation or repairs; and (d) the permanent improvement of school grounds?",11,11,GO Bond,11,11,Education: Bonds,323,246,569,0.5676625659050967,T,2,FailT,0,199600212,323,246,569,0.5676625659050967,2,FailT,10,10
199600214,1996,49,3,SONOMA,1996-06-04,SEBASTOPOL UNION SCHOOL DISTRICT,0,M,B,"To enable the Sebastopol Union Elementary School District to provide access to technology for our students, provide adequate classroom space and rehabilitate and expand existing schools, make repairs, improvements and renovations of buildings, and grounds, including classrooms and libraries, make safety and seismic upgrades, and for other purposes authorized to issue bonds in an amount not to exceed $6,400,000 with an interest rate not to exceed the maximum set by law?",11,11,GO Bond,11,11,Education: Bonds,1490,461,1951,0.7637109174782163,T,1,PassT,0,199600213,1490,461,1951,0.7637109174782163,1,PassT,10,10
199600215,1996,49,3,SONOMA,1996-06-04,WEST SONOMA UNION HIGH SCHOOL DIST.,0,M,A,"To provide vital funding to improve aging and deteriorating school facilities, including classroom access to computer technology; to upgrade libraries and vocational technology  classrooms; and to make repairs and renovations to school buildings throughout the district for student safety, shall the West Sonoma County Union High School District be authorized to finance the construction, improvement, acquisition and renovation of school facilities and grounds by issuing up to $13,300,000 in bonds at interest rates not exceeding the statutory limit?",11,11,GO Bond,11,11,Education: Bonds,5089,1856,6945,0.7327573794096474,T,1,PassT,0,199600214,5089,1856,6945,0.7327573794096472,1,PassT,10,10
199600216,1996,50,3,STANISLAUS,1996-06-04,KEYES UNION ELEMENTARY SCHOOL DISTRICT,0,M,K,"Shall the Keyes Union School District issue bonds in the principal amount of $1,620,000.00 for the purpose of construction of a new middle school on Washington Road at an interest rate not to exceed the maximum allowed by law?",11,11,GO Bond,11,11,Education: Bonds,264,106,370,0.7135135135135136,T,1,PassT,0,199600215,264,106,370,0.7135135135135136,1,PassT,10,10
199600217,1996,50,3,STANISLAUS,1996-06-04,PATTERSON JOINT UNIFIED SCHOOL DISTRICT,0,M,J,"To upgrade Patterson District schools for learning technologies including computers, to relieve classroom overcrowding, to build a science, technology and computer center for student and community use, improve the school library, modernize job and vocational training facilities, and expand and modernize local classrooms, shall the Patterson Joint Unified School District issue $3,400,000 of bonds, at an interest rate within the legal limit?",11,11,GO Bond,11,11,Education: Bonds,716,340,1056,0.678030303030303,T,1,PassT,0,199600216,716,340,1056,0.678030303030303,1,PassT,10,10
199600218,1996,31,2,PLACER,1996-09-17,COLFAX,0,R,1,Shall WARREN WEGNER be recalled (removed) from the office of Mayor?,50,50,Recall,48,46,Governance: Recall,231,207,438,0.5273972602739726,M,1,Pass,0,199600217,231,207,438,0.5273972602739726,1,Pass,50,40
199600219,1996,31,2,PLACER,1996-09-17,COLFAX,0,R,2,"Shall JOAN ESSEX be recalled (removed) from the office of Member, City Council?",50,50,Recall,48,46,Governance: Recall,227,204,431,0.5266821345707656,M,1,Pass,0,199600218,227,204,431,0.5266821345707656,1,Pass,50,40
199600220,1996,31,2,PLACER,1996-09-17,COLFAX,0,R,3,"Shall ELIZABETH ""B.J."" ARMANDO be recalled",50,50,Recall,48,46,Governance: Recall,260,174,434,0.5990783410138248,M,1,Pass,0,199600219,260,174,434,0.5990783410138248,1,Pass,50,40
199600221,1996,31,2,PLACER,1996-09-17,COLFAX,0,R,4,"Shall FRANK NANN, JR. be recalled (removed) from the office of Member, City Council?",50,50,Recall,48,46,Governance: Recall,232,198,430,0.5395348837209303,M,1,Pass,0,199600220,232,198,430,0.5395348837209303,1,Pass,50,40
199600222,1996,1,1,ALAMEDA,1996-11-05,ALAMEDA,0,M,C,Shall the Charter of the County of Alameda be amended to provide that not to exceed two persons serving as Assistant Sheriff shall be included in the unclassified service of the County?,20,20,Charter Amendment,32,32,Safety: Police,234964,115436,350400,0.6705593607305936,M,1,Pass,0,199600221,234964,115436,350400,0.6705593607305936,1,Pass,20,30
199600223,1996,1,1,ALAMEDA,1996-11-05,ALAMEDA,0,M,D,"Shall County ordinances be approved in order to approve and continue until June 30, 2001 the existing 5.5% Utility Users Tax which is collected only in the unincorporated areas of the County (e.g. Ashland, Castro Valley, Cherryland, Fairview, San Lorenzo, Sunol) and DOES NOT APPLY in the cities of Alameda, Albany, Berkeley, Dublin, Emeryville, Fremont, Hayward, Livermore, Newark, Oakland, Piedmont, Pleasanton, San Leandro, or Union City, the proceeds of which are used to fund general county services to the unincorporated areas, including, but not limited to, Sheriff=s Department services, County library services, and County planning services?",5,5,Utility Tax,100,115,Revenues: Revenue Use,242259,115586,357845,0.6769942293451076,M,1,Pass,0,199600222,242259,115586,357845,0.6769942293451076,1,Pass,1,110
199600224,1996,1,1,ALAMEDA,1996-11-05,ALAMEDA,0,M,E,"Shall the Charter of the County of Alameda be amended to restrict generally the powers of the Board of Supervisors to change County health care services; including a specific restriction on the powers of the Board to (1) reduce the level of medical services provided at the Alameda County Medical Center, (2) close, lease, sell or transfer Alameda County Medical Center assets and (3) transfer the management or change the governance of the Alameda County Medical Center, be approved?",20,20,Charter Amendment,72,72,Facilities: Health Facilities,181082,186190,367272,0.49304602583371454,M,2,Fail,0,199600223,181082,186190,367272,0.49304602583371454,2,Fail,20,70
199600225,1996,3,1,AMADOR,1996-11-05,AMADOR,0,M,R,Should the Amador County Board of Supervisors seek from the California Legislature an amendment to Section 95-7.1 of the Amador Water Agency Act to change the governing body of the Amador Water Agency from an independently elected board of directors to the Amador County Board of Supervisors?  This is an advisory vote only.  The Board of Supervisors has not taken a position on the merits of this matter.,30,30,Advisory,43,43,Governance: Organization,5211,8068,13279,0.39242412832291595,M,2,Fail,0,199600224,5211,8068,13279,0.3924241283229159,2,Fail,30,40
199600226,1996,4,1,BUTTE,1996-11-05,BUTTE,0,M,C,"Shall the ""Initiative Ordinance Amending Butte County General Plan and Comprehensive Zoning Ordinance; Repealing Agricultural Protection Zone; and Rezoning U (Unclassified) Zones"" be adopted?",40,40,Initiative,22,22,Land Use: Zoning,11451,58880,70331,0.16281582801325162,M,2,Fail,0,199600225,11451,58880,70331,0.16281582801325162,2,Fail,40,20
199600227,1996,4,1,BUTTE,1996-11-05,BUTTE,0,M,D,"Shall the initiative County Charter amendment entitled ""Public Safety Priority"", requiring that the annual budget of each County ""Public Safety Agency"" be at least as great as the ""Base Year Budget"", be adopted?  Base Year Budget"" for each such agency is defined as the greater of (1) the total spending authorizations approved for the prior fiscal year, plus inflationary increases, or (2) the amount approved as the 1995-96 budget, plus later approved augmentations and cumulative annual ""inflationary increases. ""  ""Base Year Budget"" includes certain revenues beyond County control, such as State and Federal grants and reimbursements, but excludes funding for capital projects.",20,20,Charter Amendment,30,30,Safety,21553,46870,68423,0.3149964193326805,M,2,Fail,0,199600226,21553,46870,68423,0.3149964193326805,2,Fail,20,30
199600228,1996,4,1,BUTTE,1996-11-05,BUTTE,0,M,E,"Shall the County Charter amendment entitled ""Public Protection Priority"", requiring that the annual budget of each County ""Public Safety Agency"" be at least as great as the ""Base Year Budget"" be adopted?  ""Base Year Budget"" is defined as the amount aproved as the FY 1995-96 budget, plus approved augmentations to that budget.  ""Base Year Budget"" excludes certain revenues beyond County control, such as State and Federal grants and reimbursements, one-time spending authorizations, and funding for capital outlay urposes.",20,20,Charter Amendment,30,30,Safety,15761,52637,68398,0.23043071434837278,M,2,Fail,0,199600227,15761,52637,68398,0.23043071434837276,2,Fail,20,30
199600229,1996,4,1,BUTTE,1996-11-05,BUTTE,0,M,F,"Shall the initiative ordinance regarding ""Regulation of the Extraction of Groundwater within the Butte Groundwater Basin"" be adopted, which ordinance would establish a County Water Department and, with specified exceptions, require permits for the extraction of groundwater, said permits to be issued only in compliance with specified standards and with a Water Management plan to be prepared?",40,40,Initiative,104,112,Revenues: Tax Creation/Incr./Contin.,18574,51393,69967,0.2654680063458488,M,2,Fail,0,199600228,18574,51393,69967,0.2654680063458488,2,Fail,40,110
199600230,1996,4,1,BUTTE,1996-11-05,BUTTE,0,M,G,"Shall the ordinance entitled ""An Ordinance to Protect the Groundwater Resources in Butte County"" be adopted, which ordinance would, with specified exceptions, require permits for the extraction of groundwater for use 1) outside the County or 2) to substitute for surface water normally used within the County but transferred or proposed to be transferred for use outside the County?",70,70,Ordinance,104,112,Revenues: Tax Creation/Incr./Contin.,37185,32472,69657,0.5338300529738577,M,1,Pass,0,199600229,37185,32472,69657,0.5338300529738577,1,Pass,70,110
199600231,1996,7,1,CONTRA COSTA,1996-11-05,CONTRA COSTA,0,M,A,"ADVISORY MEASURE.  Shall the Board of Supervisors establish a Citizens Commission on Local Government Efficiency, the majority of whom shall be from outside government, to examine issues related to local government for the purpose of making government in Contra Costa more cost efficient and effective, to draft and present a County Charter to the Board of Supervisors for possible submission to local voters at a subsequent election?",30,30,Advisory,40,40,Governance,206289,98691,304980,0.6764017312610663,M,1,Pass,0,199600230,206289,98691,304980,0.6764017312610663,1,Pass,30,40
199600232,1996,9,1,EL DORADO,1996-11-05,EL DORADO,0,M,J,Shall the action of the Board of Supervisors increasing the transient occupancy tax from 8% to 10% be ratified?,2,2,Business Tax,200,201,Other: Promotion of Tourism,27767,30522,58289,0.47636775377858603,M,2,Fail,0,199600231,27767,30522,58289,0.47636775377858603,2,Fail,1,200
199600233,1996,9,1,EL DORADO,1996-11-05,EL DORADO,0,M,K,"Shall Measure K be adopted, establishing: (a) traffic generation standards for approving residential subdivisions of five or more parcels, more restrictive than certain standards in El Dorado County's General Plan; and, (b) standards for use by County in determining whether adequate water supplies are available prior to approval of residential subdivisions within El Dorado Irrigation District's service area, including water allocations for current EID users, for nonresidential uses, and for existing or approved, but undeveloped, residential parcels?",70,70,Ordinance,24,24,Land Use: Private Projects,29488,31034,60522,0.48722778493770863,M,2,Fail,0,199600232,29488,31034,60522,0.4872277849377086,2,Fail,70,20
199600234,1996,11,1,GLENN,1996-11-05,GLENN,0,R,,Shall LEWIS K. DONNELLEY be recalled (removed) from the office of Sheriff-Coroner for the County of Glenn?,50,50,Recall,48,46,Governance: Recall,3579,4929,8508,0.4206629055007053,M,2,Fail,0,199600233,3579,4929,8508,0.42066290550070523,2,Fail,50,40
199600235,1996,13,1,IMPERIAL,1996-11-05,IMPERIAL,0,M,G,"Do you approve of changing the office of Imperial County Auditor/Controller from an elective position to an appointive position effective January 1, 1999?",70,70,Ordinance,42,42,Governance: Personnel/Labor Relations,6731,16990,23721,0.283757008557818,M,2,Fail,0,199600234,6731,16990,23721,0.283757008557818,2,Fail,70,40
199600236,1996,13,1,IMPERIAL,1996-11-05,IMPERIAL,0,M,H,"Do you approve of changing the office of Imperial County Public Administrator/Guardian/Conservator from and Elective position to an appointive position eftective January 1, 1999?",70,70,Ordinance,42,42,Governance: Personnel/Labor Relations,6675,17052,23727,0.2813250727019851,M,2,Fail,0,199600235,6675,17052,23727,0.2813250727019851,2,Fail,70,40
199600237,1996,14,1,INYO,1996-11-05,INYO,0,M,A,Shall the Board of Supervisors establish the consolidated office of the Director of Finance to perform the duties of Auditor-Controller and Treasurer-Tax Collector for Into County?,70,70,Ordinance,42,42,Governance: Personnel/Labor Relations,1752,5425,7177,0.2441131391946496,M,2,Fail,0,199600236,1752,5425,7177,0.24411313919464958,2,Fail,70,40
199600238,1996,14,1,INYO,1996-11-05,INYO,0,M,B,"If the offices of County Auditor-Controller and County Treasurer-Tax Collector are to be consolidated into a single office of County Director of Finance, shall the Board of Supervisors establish the position of County Director of Finance as an elective office?",70,70,Ordinance,42,42,Governance: Personnel/Labor Relations,4536,2473,7009,0.647167926951063,M,1,Pass,0,199600237,4536,2473,7009,0.647167926951063,1,Pass,70,40
199600239,1996,15,1,KERN,1996-11-05,KERN,0,M,L,Shall the Kern County Civil Service Ordinance (Chapter 3.04) be amended to provide: (1) that department heads and other appointees of the Board of Supervisors are exempt from the civil service system; (2) that the Board of Supervisors shall appoint a Human Resources Administrator who shall manage the system and implement the rules adopted by the Civil service Commission and the Board of Supervisors; (3) that employees appealing a disciplinary action have the option of a hearing before either an arbitrator or the Civil Service Commission; and (4) that the language of the Ordinance be made consistent with current federal and state law?,70,70,Ordinance,42,42,Governance: Personnel/Labor Relations,63420,80344,143764,0.4411396455301745,M,2,Fail,0,199600238,63420,80344,143764,0.44113964553017443,2,Fail,70,40
199600240,1996,16,1,KINGS,1996-11-05,KINGS,0,M,G,"Shall the Board of Supervisors be prohibited from arranging for solid waste collection, from selecting waste haulers for the collection of solid waste, and from rrequiring mandatory collection of solid waste within the unincorporated territory of Kings County?",70,70,Ordinance,200,103,General Services: Solid Waste,13695,10447,24142,0.5672686604258139,M,1,Pass,0,199600239,13695,10447,24142,0.5672686604258139,1,Pass,70,100
199600241,1996,19,1,LOS ANGELES,1996-11-05,LOS ANGELES,0,M,A,"NEIGHBORHOOD AND REGIONAL PARK, RECREATION AND RELATED IMPROVEMENTS; FUNDING.  To improve the safety of neighborhood and regional parks and recreational areas for children and families, prevent gangs, remove graffiti, build senior centers, protect and restore park and beach lands and Santa Monica Bay, shall an additional assessment within the Los Angeles County Regional Park and Open Space District be authorized, the assessment method be amended, and expenditure of District revenues for all authorized purposes of the District be permitted, only in accordance with the District's resolution?",3,3,Property Tax,51,51,Environment: Parks/Recreation,1439597,772783,2212380,0.6507006029705565,M,1,Pass,0,199600240,1439597,772783,2212380,0.6507006029705565,1,Pass,1,50
199600242,1996,19,1,LOS ANGELES,1996-11-05,LOS ANGELES,0,M,B,CONDUCT OF POLITICAL CAMPAIGNS FOR COUNTY OFFICES.  Shall the ordinance enacting Chapter 2.190 of the Los Angeles County Code to provide limits on the campaign contributions and expenditures of county officeholders and candidates for county offices be adopted?,70,70,Ordinance,45,45,Governance: Political Reform/Term Limits,1544685,499355,2044040,0.7557019432105047,M,1,Pass,0,199600241,1544685,499355,2044040,0.7557019432105047,1,Pass,70,40
199600243,1996,19,1,LOS ANGELES,1996-11-05,LOS ANGELES,0,M,C,"CHARTER AMENDMENT.  Authorize the Los Angeles County Board of Supervisors to establish and designate by ordinance, after a public hearing, unclassified senior executive positions in County agencies and departments, with a total number of such new unclassified positions County-wide not to exceed 1/4 percent of the total County workforce or up to 1/2 percent, if approved by a four-fifths vote of the Board of Supervisors.",20,20,Charter Amendment,42,42,Governance: Personnel/Labor Relations,837680,1029910,1867590,0.44853527808566124,M,2,Fail,0,199600242,837680,1029910,1867590,0.4485352780856612,2,Fail,20,40
199600244,1996,20,1,MADERA,1996-11-05,MADERA,0,M,J,"Shall the County of Madera be authorized to issue general obligation bonds in a principal amount not to exceed Fifteen Million Two Hundred Thousand Dollars ($15,20,000) to pay for the construction and completion of new juvenile justice detention facilities consisting of a Boot Camp and new Juvenile Hall and related costs of land acquisition, construction and all required fixtures and appurtenances?",11,11,GO Bond,31,31,Safety: Jails/Courts,18568,10865,29433,0.630856521591411,T,2,FailT,0,199600243,18568,10865,29433,0.630856521591411,2,FailT,10,30
199600245,1996,20,1,MADERA,1996-11-05,MADERA,0,M,K,ANNUAL SURVEY OF PREVAILING WAGES AND BENEFITS.  Shall the County's Civil Service System Ordinance be amended by deleting its requirement for an annual survey of prevailing wages and benefits for County Employees?,70,70,Ordinance,41,41,Governance: Benefits/Compensation,12321,15336,27657,0.445493003579564,M,2,Fail,0,199600244,12321,15336,27657,0.44549300357956395,2,Fail,70,40
199600246,1996,20,1,MADERA,1996-11-05,MADERA,0,M,L,"Shall the County's Civil Service System Ordinance be amended to provide that County employees who are disciplined for cause by means of (1) a suspension from work without pay for a period of three (3) days or less, or (2) by means of an equivalent demotion, are entitled to appeal such suspensions or demotions to the County Administrative Office, rather than to the County Civil Service Commission?",70,70,Ordinance,42,42,Governance: Personnel/Labor Relations,13609,13608,27217,0.5000183708711468,M,1,Pass,0,199600245,13609,13608,27217,0.5000183708711468,1,Pass,70,40
199600247,1996,20,1,MADERA,1996-11-05,MADERA,0,M,M,"Shall the County's Civil Service System Ordinance be amended to provide that a County employee's absence without an approved leave of absence for five (5) consecutive working days or more is an automatic resignation from County employment, subject to reinstatement upon satisfactory explanation?",70,70,Ordinance,42,42,Governance: Personnel/Labor Relations,20873,7527,28400,0.7349647887323945,M,1,Pass,0,199600246,20873,7527,28400,0.7349647887323943,1,Pass,70,40
199600248,1996,21,1,MARIN,1996-11-05,MARIN,0,M,H,"Shall the increase in appropriations limit equal to the proceeds of the special tax authorized by the voters of this area on April 14, 1992, continue in effect for fiscal years 1996-1997, 1997-1998, 1998-1999, 1999-2000?",60,60,Gann Limit,40,40,Governance,114,26,140,0.8142857142857143,M,1,Pass,0,199600247,114,26,140,0.8142857142857143,1,Pass,60,40
199600249,1996,21,1,MARIN,1996-11-05,MARIN,0,M,A,"Shall a transaction and use tax (sales tax) of one quarter of one percent of the sales price of taxable personal property sold within Marin County in accordance with a proposed ordinance be levied for 10 years, an appropriations limit equal to the proceeds of such tax be established, with the proceeds to be used soley for: maintaining public parks, park services, reducing fire hazards, and preserving open space and agricultural lands in Marin County?",4,4,Sales Tax,51,51,Environment: Parks/Recreation,62254,45708,107962,0.5766288138419073,T,2,FailT,0,199600248,62254,45708,107962,0.5766288138419073,2,FailT,1,50
199600250,1996,21,1,MARIN,1996-11-05,MARIN,0,M,G,"Shall the increase in appropriations limit equal to the proceeds of the special tax authorized by the voters on June 4, 1985 continue in effect for fiscal years 1996-1997 through and including 1999-2000?",60,60,Gann Limit,40,40,Governance,618,176,794,0.7783375314861463,M,1,Pass,0,199600249,618,176,794,0.7783375314861462,1,Pass,60,40
199600251,1996,23,1,MENDOCINO,1996-11-05,MENDOCINO,0,M,A,"Shall an additional transient occupancy tax of two percent (2%) be imposed, as set forth in Ordinance No. 3939 on the rent charged by an operator and payable by a transient for the privilege of occupying any hotel?",2,2,Business Tax,200,110,Revenues,15151,15365,30516,0.4964936426792502,T,2,FailT,0,199600250,15151,15365,30516,0.4964936426792502,2,FailT,1,110
199600252,1996,27,1,MONTEREY,1996-11-05,MONTEREY,0,M,E,Shall the Agricultural Land and Resource Conservation Initiative be approved?,40,40,Initiative,23,23,Land Use: Open Space,43658,57210,100868,0.43282309553079273,M,2,Fail,0,199600251,43658,57210,100868,0.43282309553079273,2,Fail,40,20
199600253,1996,27,1,MONTEREY,1996-11-05,MONTEREY,0,M,M,Shall Ordinance No. 03857 approving rezoning of portions of the Santa Lucia Preserve subdivision (also known as Rancho San Carlos) be approved?,70,70,Ordinance,22,22,Land Use: Zoning,46556,57208,103764,0.4486719864307467,M,2,Fail,0,199600252,46556,57208,103764,0.4486719864307467,2,Fail,70,20
199600254,1996,28,1,NAPA,1996-11-05,NAPA,0,M,Z,"Should Ordinance No. 96-3 be acopted?  (if the ordinance is adopted, the land use regulations of the County will be changed to create a new zoning district and include a single parcel located at 3100 Golden Gate Drive, south of the City of Napa, within that zoning district.  Existing roadside stand operations located on parcels that are included within the new zoning district will be permitted to (i) sell agricultural produce, fruits, vegetables and Christmas trees which are grown on or off the parcel on which the roadside stand is located, (ii) sell related non-agricultural items, (iii) conduct certain limited commercial activities involving the recreational/educational use of animals, such as petting zoos and pony rides, and (iv) construct such structures as are needed to enable such sales and commercial activities to occur.  Only parcels designated on the Napa County Gneeral Plan as Agriclture Watershed and Open Space are eligible to be included within this zoning district).",70,70,Ordinance,22,22,Land Use: Zoning,25184,20836,46020,0.5472403302911778,M,1,Pass,0,199600253,25184,20836,46020,0.5472403302911778,1,Pass,70,20
199600255,1996,30,1,ORANGE,1996-11-05,ORANGE,0,M,A,"Shall Section 1-2-9, which would establish a consecutive term limitation of two(2) consecutive four(4) year terms for the office of member of the Board of Supervisors, be added to the Codified Ordinances of Orange County?",70,70,Ordinance,45,45,Governance: Political Reform/Term Limits,591981,155626,747607,0.791834479880472,M,1,Pass,0,199600254,591981,155626,747607,0.791834479880472,1,Pass,70,40
199600256,1996,31,1,PLACER,1996-11-05,PLACER,0,M,A,"LIMIT THE ROLE OF COUNTY CIVIL SERVICE COMMISSION.  Shall Placer County Ordinance 501-B, now codified within Placer County Code, Chapter 14, governing the civil service system for employees of the County be amended to eliminate all duties and responsibilities of the Civil Service Commission, with the exception of its duties and responsibilities as a hearing body for employee grievances, disciplinary appeals and such other matters for which a hearing is provided?",70,70,Ordinance,43,43,Governance: Organization,35533,38413,73946,0.4805263300246126,M,2,Fail,0,199600255,35533,38413,73946,0.48052633002461254,2,Fail,70,40
199600257,1996,31,1,PLACER,1996-11-05,PLACER,0,M,B,"APPOINTMENT OF COUNTY CIVIL SERVICE COMMISSIONERS.  Shall Sections 14.101 and 14.102 of County Ordinance 501-B, now codified as Placer County Code Sections 14.1010 and 14.1020 be amended to require that the appointment of the five (5) member Civil Service Commission be by supervisorial district by the supervisor representing that district and that the term of appointment shall be the same as the County Supervisor making the appointment?",70,70,Ordinance,42,42,Governance: Personnel/Labor Relations,25910,47000,72910,0.35536963379508985,M,2,Fail,0,199600256,25910,47000,72910,0.35536963379508985,2,Fail,70,40
199600258,1996,31,1,PLACER,1996-11-05,PLACER,0,M,C,"MEETINGS OF COUNTY CIVIL SERVICE COMMISSION.  Shall Section 14.103 of County Ordinance 501-B, now codified as Placer County Code Section 14.1030, be amended to allow the Civil Service Commission to decide the need and frequency to hold its meetings, rather than the current requirement of meetings once a month regardless of the amount or absence of business to conduct?",70,70,Ordinance,43,43,Governance: Organization,42670,30926,73596,0.5797869449426599,M,1,Pass,0,199600257,42670,30926,73596,0.5797869449426599,1,Pass,70,40
199600259,1996,31,1,PLACER,1996-11-05,PLACER,0,M,D,"APPOINTMENT OF DIRECTOR OF PERSONNEL.  Shall Section 14.104 of County Ordinance 501-B, now codified as Placer County Code Section 14.1050 be amended to require the appointment of the Director of Personnel by the County Executive Officer, rather than the Civil Service Commission as under current law, and that the position be placed in the unclassified service consistent with other Department Heads of the County?",70,70,Ordinance,42,42,Governance: Personnel/Labor Relations,32284,40180,72464,0.4455177743431222,M,2,Fail,0,199600258,32284,40180,72464,0.4455177743431221,2,Fail,70,40
199600260,1996,31,1,PLACER,1996-11-05,PLACER,0,M,L,"Shall Placer County Code, Chapter 21, Section 21.3 be amended to impose a general tax under the provisions of Government Code Section 53723, which would increase the rate of Transient Occupancy Tax from EIGHT (8%) PERCENT TO ten (10%) percent for that area legally described as the ""Western Slope Transient Occupancy Tax Area,"" to read as set forth in Exhibit ""A"" of Resolution 96-177 adopted by the Placer County Board of Supervisors on June 25, 1996 and on file in the Office of the Clerk of the Board of Supervisors?",2,2,Business Tax,100,112,Revenues: Tax Creation/Incr./Contin.,11361,20755,32116,0.3537489102005231,M,2,Fail,0,199600259,11361,20755,32116,0.3537489102005231,2,Fail,1,110
199600261,1996,34,1,SACRAMENTO,1996-11-05,SACRAMENTO,0,M,A,"CHARTER AMENDMENT RELATING TO CIVIL SERVICE EXEMPTION.  Section 71-D of the Sacramento County Charter excludes from Civil Service specifically identified personnel by position, including department head, one assistant to each County Supervisor, and the chief deputy to each elective officer.  Shall Section 71-D be amended to expand designated positions to include all assistants to each Supervisor, secretaries to each Supervisor, the secretary to the County Executive, all assistant or deputy department heads and to additionally exclude from Civil Service positions designated as 'Management?'; provided the total number of exempt positions does not exceed 5% of the total number of permanent County positions?",20,20,Charter Amendment,42,42,Governance: Personnel/Labor Relations,99427,220254,319681,0.31101942248679154,M,2,Fail,0,199600260,99427,220254,319681,0.31101942248679154,2,Fail,20,40
199600262,1996,34,1,SACRAMENTO,1996-11-05,SACRAMENTO,0,M,B,"CHARTER AMENDMENT RELATING TO CONTRACTING FOR COUNTY SERVICES.  The Sacramento County Charter restricts the ability of the County to contract for the provision of services traditionally provided by civil service personnel.  Shall Section 71-J be added to the Charter to permit contracting for such services for reasons of economy and efficiency provided there is no displacement of existing civil service employees, obligations to meet and confer with employee organizations are met and the contract is publicly and competitively awarded?",20,20,Charter Amendment,47,47,Governance: Contracting/Bidding/Leasing,166721,160593,327314,0.5093610416908534,M,1,Pass,0,199600261,166721,160593,327314,0.5093610416908534,1,Pass,20,40
199600263,1996,34,1,SACRAMENTO,1996-11-05,SACRAMENTO,0,M,C,CHARTER AMENDMENT RELATING TO DIRECTOR OF FINANCE.  Section 24 and 27 of the Sacramento County Charter require the election of an Auditor of the County of Sacramento and the appointment of a Treasurer.  Shall Sections 24 and 27 be amended to allow he consolidation of these offices into the appointive position of Director of Finance.,20,20,Charter Amendment,42,42,Governance: Personnel/Labor Relations,177459,139661,317120,0.559595736629667,M,1,Pass,0,199600262,177459,139661,317120,0.559595736629667,1,Pass,20,40
199600264,1996,34,1,SACRAMENTO,1996-11-05,SACRAMENTO,0,M,D,"COUNTY LIBRARY TAX.  To restore open hours, funding for new books and updated technology in all branch libraries shall a service charge-benefit assessment be imposed for no more than ten (10) years within a community facilities district encompassing the unincorporated area of Sacramento County to be imposed at the initial rate of $22.00 per year for single family dwellings and all other properties at specified proportional amounts, with adjustments not exceeding 3% annually or more than $7.00 for s single family residence during the duration of the tax, exempting common areas, agricultural property and public agencies.",3,3,Property Tax,71,71,Facilities: Libraries,135188,95998,231186,0.5847585926483437,T,2,FailT,0,199600263,135188,95998,231186,0.5847585926483437,2,FailT,1,70
199600265,1996,35,1,SAN BENITO,1996-11-05,SAN BENITO,0,M,E,Shall an ordinance establishing a business license tax on mineral depletion businesses be approved?,2,2,Business Tax,100,112,Revenues: Tax Creation/Incr./Contin.,4991,7815,12806,0.3897391847571451,M,2,Fail,0,199600264,4991,7815,12806,0.3897391847571451,2,Fail,1,110
199600266,1996,37,1,SAN DIEGO,1996-11-05,SAN DIEGO,0,M,A,County Community and Branch Library Improvement Ordinance - 1/4 cent transactions and use tax for library purposes.,4,4,Sales Tax,71,71,Facilities: Libraries,486432,336858,823290,0.5908391939656743,T,2,FailT,0,199600265,486432,336858,823290,0.5908391939656743,2,FailT,1,70
199600267,1996,37,1,SAN DIEGO,1996-11-05,SAN DIEGO,0,M,B,Charter Amendment.  Would change the positions of County Counsel and the principal assistants from Classified to Unclassified Service.,20,20,Charter Amendment,42,42,Governance: Personnel/Labor Relations,423213,302358,725571,0.5832826835692165,M,1,Pass,0,199600266,423213,302358,725571,0.5832826835692165,1,Pass,20,40
199600268,1996,38,1,SAN FRANCISCO,1996-11-05,SAN FRANCISCO,0,M,A,"AFFORDABLE HOUSING BONDS, 1996.  To incur bonded indebtedness of $100,000,000 for the financing of (1) the development of housing affordable to low-income households in the City and County of San Francisco and (2) down-payment assistance to low- and moderate-income first-time home buyers, and all other costs necessary or convenient for the foregoing purposes?",10,10,Bonds,81,81,Housing: Affordable,176599,85246,261845,0.6744409860795508,T,1,PassT,0,199600267,176599,85246,261845,0.6744409860795508,1,PassT,10,80
199600269,1996,38,1,SAN FRANCISCO,1996-11-05,SAN FRANCISCO,0,M,B,"DE YOUNG MUSEUM REPLACEMENT BONDS, 1996.  To incur bonded indebtedness of $73,300,000 for the acquisition, construction and/or reconstruction of a new museum facility to replace the de Young Museum and all other works, property, and structures necessary or convenient for the foregoing purposes.",11,11,GO Bond,70,70,Facilities,166923,99716,266639,0.6260262002182726,T,2,FailT,0,199600268,166923,99716,266639,0.6260262002182726,2,FailT,10,70
199600270,1996,38,1,SAN FRANCISCO,1996-11-05,SAN FRANCISCO,0,M,C,Shall the City increase the cost of living adjustments paid to most city retirees?,70,70,Ordinance,41,41,Governance: Benefits/Compensation,130258,126703,256961,0.5069173921334366,M,1,Pass,0,199600269,130258,126703,256961,0.5069173921334366,1,Pass,70,40
199600271,1996,38,1,SAN FRANCISCO,1996-11-05,SAN FRANCISCO,0,M,D,Shall the City increase pension benefits for firefighters hired after 1976?,70,70,Ordinance,41,41,Governance: Benefits/Compensation,150017,110108,260125,0.5767111965401249,M,1,Pass,0,199600270,150017,110108,260125,0.5767111965401249,1,Pass,70,40
199600272,1996,38,1,SAN FRANCISCO,1996-11-05,SAN FRANCISCO,0,M,E,"Shall the Board of Supervisors, rather than the voters, approve changes in City employee retirement and health benefits and other Charter rules governing City employment?",20,20,Charter Amendment,41,41,Governance: Benefits/Compensation,71114,188567,259681,0.2738513791921627,M,2,Fail,0,199600271,71114,188567,259681,0.2738513791921627,2,Fail,20,40
199600273,1996,38,1,SAN FRANCISCO,1996-11-05,SAN FRANCISCO,0,M,F,"Shall the salary paid to members of the Board of Supervisors be increased from $23,924 to $50,000, and shall Board members be permitted to receive City Retirement benefits?",70,70,Ordinance,41,41,Governance: Benefits/Compensation,96036,166087,262123,0.36637761661510054,M,2,Fail,0,199600272,96036,166087,262123,0.36637761661510054,2,Fail,70,40
199600274,1996,38,1,SAN FRANCISCO,1996-11-05,SAN FRANCISCO,0,M,G,"Shall the Board of Supervisors be elected by district, and shall there be district run-off elections if no candidate receives a majority of the votes cast in a district?",20,20,Charter Amendment,48,48,Governance: Elections,142163,108378,250541,0.5674240942600213,M,1,Pass,0,199600273,142163,108378,250541,0.5674240942600213,1,Pass,20,40
199600275,1996,38,1,SAN FRANCISCO,1996-11-05,SAN FRANCISCO,0,M,H,Shall the Board of Supervisors be elected using preference voting?,70,70,Ordinance,48,48,Governance: Elections,103787,134263,238050,0.43598823776517537,M,2,Fail,0,199600274,103787,134263,238050,0.43598823776517537,2,Fail,70,40
199600276,1996,38,1,SAN FRANCISCO,1996-11-05,SAN FRANCISCO,0,M,I,"Shall the Police Commission and Fire Commission establish the rules and procedures for recruiting, hiring, and promoting police officers and firefighters, and conduct civil service tests for these employees?",20,20,Charter Amendment,34,34,Safety: Multiple Emergency Services,111810,132656,244466,0.4573642142465619,M,2,Fail,0,199600275,111810,132656,244466,0.4573642142465619,2,Fail,20,30
199600277,1996,38,1,SAN FRANCISCO,1996-11-05,SAN FRANCISCO,0,M,J,"Shall taxicab permit holders be permitted to sell their permits, and shall the City make other changes to the laws which regulate taxicabs?",70,70,Ordinance,61,61,Transport: Mass Transit,87014,170509,257523,0.3378882662907779,M,2,Fail,0,199600276,87014,170509,257523,0.3378882662907779,2,Fail,70,60
199600278,1996,40,1,SAN LUIS OBISPO,1996-11-05,SAN LUIS OBISPO,0,M,H,"Shall San Luis Obispo County General Hospital be established by ordinance in order to require that any decision to close, sell or lease the hospital would need to be approved by a vote of the people?",70,70,Ordinance,72,72,Facilities: Health Facilities,66629,24604,91233,0.7303168809531638,M,1,Pass,0,199600277,66629,24604,91233,0.7303168809531638,1,Pass,70,70
199600279,1996,41,1,SAN MATEO,1996-11-05,SAN MATEO,0,M,T,Shall the initiative ordinance changing the San Mateo County Local Coastal Program to substitute a tunnel alternative at Devil's Slide in place of a bypass on Route 1 be adopted?,40,40,Initiative,62,62,Transport: Roads,170148,60441,230589,0.737884287628638,M,1,Pass,0,199600278,170148,60441,230589,0.737884287628638,1,Pass,40,60
199600280,1996,43,1,SANTA CLARA,1996-11-05,SANTA CLARA,0,M,A,"THIS MEASURE DOES NOT INCREASE TAXES.  Shall any new voter-approved sales tax fund these transportation improvements?  Fix streets, potholes; link to BART; synchronize all expressways; build Tasman, Capitol, Vasona Light Rails; widen Highways 880, 101, 87, 17; increase Caltrain service; upgrade 237/880, 85/101, 85/87 interchanges; improve safety:  Pacheco Pass, Highway 85; expand bicycle routes; improve senior, disabled transit service.",4,4,Sales Tax,62,62,Transport: Roads,366387,105551,471938,0.7763456216706431,T,1,PassT,0,199600279,366387,105551,471938,0.7763456216706431,1,PassT,1,60
199600281,1996,43,1,SANTA CLARA,1996-11-05,SANTA CLARA,0,M,B,"Shall the Board of Supervisors enact a 1/2 cent sales tax for general county purposes with the following mandatory restrictions?  The sales tax must expire after nine years; a Citizens Watchdog committee, selected independently with direction from the County Grand Jury and the League of Women voters, will conduct yearly audits of all sales tax expenditures; these yearly sales tax expenditure audits must be reported to the public and published in local newspapers.",4,4,Sales Tax,100,112,Revenues: Tax Creation/Incr./Contin.,240610,223679,464289,0.5182332555800374,T,2,FailT,0,199600280,240610,223679,464289,0.5182332555800374,2,FailT,1,110
199600282,1996,43,1,SANTA CLARA,1996-11-05,SANTA CLARA,0,M,C,"Shall Section 203 of the Santa Clara County Charter, which currently provides that a vacancy in the office of supervisor be filled only by appointment, be amended to provide that a vacancy be filled by election or appointment?",20,20,Charter Amendment,42,42,Governance: Personnel/Labor Relations,291841,134508,426349,0.6845119843133209,M,1,Pass,0,199600281,291841,134508,426349,0.6845119843133208,1,Pass,20,40
199600283,1996,49,1,SONOMA,1996-11-05,SONOMA,0,M,D,"Shall a county ordinance be adopted requiring county voter approval of changes to a community separator adjacent to a city, where the voters of that city have approved an urban growth boundary effective for 20 years?",70,70,Ordinance,21,21,Land Use: Growth Cap/Boundary,111423,47536,158959,0.7009543341364755,M,1,Pass,0,199600282,111423,47536,158959,0.7009543341364755,1,Pass,70,20
199600284,1996,49,1,SONOMA,1996-11-05,SONOMA,0,M,E,"Shall the Community Hospital Management Ordinance, which (a) shifts management of Hospital to Board of Trustees; (b) invalidates any closure, lease, sale or transfer of management of Hospital made prior to election; (c) requires voter approval for subsequent closure, lease, sale or transfer of management of Hospital; (d) requires approval of Trustees or voters before any reduction of Hospital services; and (e) requires preservation of labor agreements and Civil Service rules at Hospital, be adopted?",70,70,Ordinance,72,72,Facilities: Health Facilities,62537,95025,157562,0.3969040758558536,M,2,Fail,0,199600283,62537,95025,157562,0.3969040758558536,2,Fail,70,70
199600285,1996,51,1,SUTTER,1996-11-05,SUTTER,0,M,BB,To approve low rent housing in unincorporated areas to comply with state requirements.,70,70,Ordinance,81,81,Housing: Affordable,9502,13688,23190,0.4097455799913756,M,2,Fail,0,199600284,9502,13688,23190,0.4097455799913756,2,Fail,70,80
199600286,1996,57,1,YOLO,1996-11-05,YOLO,0,M,C,"Shall the Initiative Regulating Commercial Mining, which amends the Yolo County General Plan, allows limited commercial sand and gravel mining above the groundwater table outside of Cache Cree, while prohibiting sand and in-channel mining in Cache Creek, other than mining rights vested by law, be adopted?  This measure also requires an approved reclamation plan, surety bonds, and a five year permit review, as required by existing law.",40,40,Initiative,54,54,Environment: Regulation/Mitigation,20217,30725,50942,0.39686309921086727,M,2,Fail,0,199600285,20217,30725,50942,0.39686309921086727,2,Fail,40,50
199600287,1996,57,1,YOLO,1996-11-05,YOLO,0,M,D,"Shall the resolution amending the Yolo County General Plan, which limits gravel extraction in Cache Creek to stream maintenance, regulates all other commercial gravel mining in the Cache Creek area, required commercial mining interests to fund water quality protection, protects agricultural land, and restores riparian habitat along Cache Creek, be adopted?  This resolution affirms enactment of the Cache Creek Area Plan, comprised of the Off-Channel Mining Plan and the Cache Creek Resources Management Plan.",70,70,Ordinance,54,54,Environment: Regulation/Mitigation,31463,19918,51381,0.6123469765088262,M,1,Pass,0,199600286,31463,19918,51381,0.6123469765088262,1,Pass,70,50
199600288,1996,1,2,ALAMEDA,1996-11-05,ALBANY,0,M,L,"Do you vote to adopt a City Council Proposed Charter Measure, as recommended by the Charter Review Committee, to change the elected Chief of Police position to an appointed position, the exact wording of which is set forth in the voter pamphlet?",20,20,Charter Amendment,32,32,Safety: Police,2228,3719,5947,0.37464267697998993,M,2,Fail,0,199600287,2228,3719,5947,0.37464267697998993,2,Fail,20,30
199600289,1996,1,2,ALAMEDA,1996-11-05,ALBANY,0,M,M,"Do you vote to adopt a City Council Proposed Charter Measure, as recommended by the Charter Review committee, to change the elected City Attorney position to an appointed position, the exact wording of which is set forth in the voter pamphlet?",20,20,Charter Amendment,42,42,Governance: Personnel/Labor Relations,1984,3852,5836,0.3399588759424263,M,2,Fail,0,199600288,1984,3852,5836,0.3399588759424263,2,Fail,20,40
199600290,1996,1,2,ALAMEDA,1996-11-05,ALBANY,0,M,N,"Do you vote to adopt a City Council Proposed Charter Measure, as recommended by the Charter Review Committee, to change the elected City treasurer position to an appointed position, the exact wording of which is set forth in the voter pamphlet?",20,20,Charter Amendment,42,42,Governance: Personnel/Labor Relations,1952,3812,5764,0.3386537126995143,M,2,Fail,0,199600289,1952,3812,5764,0.3386537126995142,2,Fail,20,40
199600291,1996,1,2,ALAMEDA,1996-11-05,ALBANY,0,M,O,"Do you vote to adopt a City Council Proposed Charter Measure, as recommended by the Charter Review Committee, pertaining to appointment and removal of persons to advisory boards, commissions, committees, and other bodies, the exact wording of which is set forth in the voter pamphlet?",20,20,Charter Amendment,42,42,Governance: Personnel/Labor Relations,1847,3389,5236,0.3527501909854851,M,2,Fail,0,199600290,1847,3389,5236,0.3527501909854851,2,Fail,20,40
199600292,1996,1,2,ALAMEDA,1996-11-05,ALBANY,0,M,P,"Do you vote to adopt a City Council Proposed Charter Measure, designated as Measure P, so that the timing of inducting of Councilmembers conforms to the time period which the County Registrar is permitted in which to canvas and certify election return?",20,20,Charter Amendment,48,48,Governance: Elections,3962,1220,5182,0.764569664222308,M,1,Pass,0,199600291,3962,1220,5182,0.764569664222308,1,Pass,20,40
199600293,1996,1,2,ALAMEDA,1996-11-05,ALBANY,0,M,Q,"Do you vote to adopt a Citizen Proposed Charter initiative pertaining to the appointment and removal of persons to advisory boards, commissions, committees, and other bodies, the exact wording of which is set forth in the Voter Pamphlet?",20,20,Charter Amendment,42,42,Governance: Personnel/Labor Relations,2642,2439,5081,0.5199763826018501,M,1,Pass,0,199600292,2642,2439,5081,0.5199763826018501,1,Pass,20,40
199600294,1996,1,2,ALAMEDA,1996-11-05,ALBANY,0,M,R,"Shall the City of Albany fund the acquisition and improvement of open space on Albany Hill to protect plant and wildlife habitat and preserve areas of Albany Hill as permanent open space, fund new playfields to provide youths with recreational opportunities, and fund creek restoration to provide cleaner water in Albany's five creeks and San Francisco Bay, all by levying an annual assessment not to exceed $69 per Equivalent Residential Unit (detached single-family home)?",3,3,Property Tax,23,23,Land Use: Open Space,4094,2558,6652,0.6154539987973542,M,1,Pass,0,199600293,4094,2558,6652,0.6154539987973542,1,Pass,1,20
199600295,1996,1,2,ALAMEDA,1996-11-05,BERKELEY,0,M,S,"To ensure the safety of its public and employees and revitalize downtown, shall the City of Berkeley issue $49 million of General Obligation Bonds at an interest rate not exceeding 12%; $30 million to acquire property, expand and retrofit the Main Library; $15 million to internally retrofit (as the most cost effective means to achieve earthquake safety) and improve the Martin Luther King, Jr. Civic Center building; and $4 million for improvements within the downtown/Civic Center area?",11,11,GO Bond,70,70,Facilities,29514,14618,44132,0.668766427988761,T,1,PassT,0,199600294,29514,14618,44132,0.668766427988761,1,PassT,10,70
199600296,1996,1,2,ALAMEDA,1996-11-05,BERKELEY,0,M,T,Shall the Berkeley City Charter be amended to provide that the Council determine the manner of giving public notice of proposed ordinances and other matters?,20,20,Charter Amendment,40,40,Governance,23983,13311,37294,0.6430793157076206,M,1,Pass,0,199600295,23983,13311,37294,0.6430793157076206,1,Pass,20,40
199600297,1996,1,2,ALAMEDA,1996-11-05,BERKELEY,0,M,U,"Shall the Library Relief Act of 1980 be amended to reauthorize the City, over a period of four years, to spend the Library Tax as approved by the voters in 1988?",70,70,Ordinance,70,70,Facilities,34524,5677,40201,0.8587846073480759,M,1,Pass,0,199600296,34524,5677,40201,0.8587846073480759,1,Pass,70,70
199600298,1996,1,2,ALAMEDA,1996-11-05,BERKELEY,0,M,V,"Shall the City of Berkeley Rent Stabilization and Eviction for Good Cause Ordinance be amended to exempt all rental housing units whose rents are subsidized under the Shelter Plus Care program (42 U.S.C. 11403 et. seq.) from the following provisions of the ordinance:  rent registration, establishment of base rent ceiling and posting, annual general adjustments of rent ceilings and individual adjustments of rent ceilings?",70,70,Ordinance,82,82,Housing: Rent Control,21274,15443,36717,0.5794046354549663,M,1,Pass,0,199600297,21274,15443,36717,0.5794046354549663,1,Pass,70,80
199600299,1996,1,2,ALAMEDA,1996-11-05,BERKELEY,0,M,W,"Shall the Berkeley Public Parks and Open Space Preservation Ordinance, Ordinance No. 5785-N.S., be amended to provide that when the President of the United States or Governor of California declare an emergency, the City Council is permitted to temporarily use public parks and public open space for other purposes, during the period necessary to protect public safety, provided that such period does not exceed one year?",70,70,Ordinance,23,23,Land Use: Open Space,29563,11615,41178,0.7179319053863715,M,1,Pass,0,199600298,29563,11615,41178,0.7179319053863714,1,Pass,70,20
199600300,1996,1,2,ALAMEDA,1996-11-05,BERKELEY,0,M,X,"Shall the Martin Luther King, Jr. Civic Center park be used for a period to expire no later than June 30, 2001 for the purpose of temporarily housing City of Berkeley offices in portable buildings, as well as associated site preparation and maintenance activities, in order to allow the abatement of seismic hazards at the site of the Martin Luther King, Jr. Civic Center Building at 218 Milvia Street if the Council finds after a public hearing that there is no other feasible alternative to relocate City employees during such seismic work?",70,70,Ordinance,70,70,Facilities,17476,23151,40627,0.43015728456445224,M,2,Fail,0,199600299,17476,23151,40627,0.43015728456445224,2,Fail,70,70
199600301,1996,1,2,ALAMEDA,1996-11-05,DUBLIN,0,M,Y,"Shall an ordinance be enacted to impose term limits on the offices of Mayor and Councilmember and to define ""term"" in cases where an individual serves less than a full term, to have the effect generally that no individual taking office after the effective date of the ordinance could serve more than eight (8) consecutive years in total in any combination of Mayor and/or Councilmember?",70,70,Ordinance,45,45,Governance: Political Reform/Term Limits,5395,2186,7581,0.7116475399023875,M,1,Pass,0,199600300,5395,2186,7581,0.7116475399023875,1,Pass,70,40
199600302,1996,1,2,ALAMEDA,1996-11-05,FREMONT,0,M,AA,Shall the people of Fremont adopt an ordinance limiting both the mayor and city council members to eight (8) consecutive years of service as mayor or city council member and reestablishing eligibility to serve after a break in service?,70,70,Ordinance,45,45,Governance: Political Reform/Term Limits,40574,12629,53203,0.7626261676973103,M,1,Pass,0,199600301,40574,12629,53203,0.7626261676973103,1,Pass,70,40
199600303,1996,1,2,ALAMEDA,1996-11-05,FREMONT,0,M,BB,"Shall the existing 2 year term of office for the mayor be made a 4 year term, consistent with that of City Councilmembers?",70,70,Ordinance,48,48,Governance: Elections,34864,16516,51380,0.6785519657454262,M,1,Pass,0,199600302,34864,16516,51380,0.6785519657454262,1,Pass,70,40
199600304,1996,1,2,ALAMEDA,1996-11-05,LIVERMORE,0,M,CC,Shall the office of City Treasurer be appointed?,70,70,Ordinance,42,42,Governance: Personnel/Labor Relations,8557,14374,22931,0.37316296716235664,M,2,Fail,0,199600303,8557,14374,22931,0.37316296716235664,2,Fail,70,40
199600305,1996,1,2,ALAMEDA,1996-11-05,OAKLAND,0,M,F,Shall Oakland=s current Council-Manager form of government be replaced with a Mayor-Council form which:  puts the Mayor in charge of the day-to-day administration of the City and the implementation of Council policy; removes the Mayor from the Council and adds an additional at-large Councilmember?,20,20,Charter Amendment,42,42,Governance: Personnel/Labor Relations,48041,54398,102439,0.4689717783266139,M,2,Fail,0,199600304,48041,54398,102439,0.4689717783266139,2,Fail,20,40
199600306,1996,1,2,ALAMEDA,1996-11-05,OAKLAND,0,M,G,"Shall the Oakland City Charter be amended at sections 1100 and 1101 to provide, beginning in 1998, for municipal nominating elections to be held on the first Tuesday following the first Monday in November in even-numbered years and for general municipal elections to be held on the second Tuesday following the second Monday in December in even-numbered years?",20,20,Charter Amendment,48,48,Governance: Elections,34298,52838,87136,0.39361457950789575,M,2,Fail,0,199600305,34298,52838,87136,0.3936145795078957,2,Fail,20,40
199600307,1996,1,2,ALAMEDA,1996-11-05,OAKLAND,0,M,H,"Shall the Oakland City Charter be amended at section 403 to provide additional duties and responsibilities for the City Auditor which would include, but not be limited to, the conduct of surveys, reviews and audits regarding internal accounting and financial controls, policy compliance and departmental performance audits, and to require quarterly public reports?",20,20,Charter Amendment,42,42,Governance: Personnel/Labor Relations,68700,22437,91137,0.7538101978340302,M,1,Pass,0,199600306,68700,22437,91137,0.7538101978340301,1,Pass,20,40
199600308,1996,1,2,ALAMEDA,1996-11-05,OAKLAND,0,M,I,"Shall the City of Oakland, in order to enrich the lives of its citizens, be authorized to issue $45,420,000 of general obligation bonds, at interest rates not to exceed the legal maximum, to repair, construct, acquire and improve libraries, museums and other cultural and recreational facilities throughout the City of Oakland?",11,11,GO Bond,71,71,Facilities: Libraries,80430,23113,103543,0.7767787296099207,T,1,PassT,0,199600307,80430,23113,103543,0.7767787296099206,1,PassT,10,70
199600309,1996,1,2,ALAMEDA,1996-11-05,OAKLAND,0,M,J,Shall the Oakland City Charter be amended to establish a Public Ethics Commission that shall advise or respond to certain City regulations and policies intended to assure fairness and openness in government and set City Councilmember compensation?,20,20,Charter Amendment,45,45,Governance: Political Reform/Term Limits,50350,43347,93697,0.5373704601001099,M,1,Pass,0,199600308,50350,43347,93697,0.5373704601001099,1,Pass,20,40
199600310,1996,1,2,ALAMEDA,1996-11-05,OAKLAND,0,M,K,"Shall the City Charter of the City of Oakland be amended to add Article XIII thereto, establishing a Kids First! Oakland Children=s Fund by requiring annually, for a twelve year period, that two and one-half percent of the City of Oakland=s unrestricted general fund revenues be set aside for the Kids First! Oakland Children=s Fund?",20,20,Charter Amendment,106,112,Revenues: Tax Creation/Incr./Contin.,71947,24445,96392,0.7464001161922151,M,1,Pass,0,199600309,71947,24445,96392,0.7464001161922151,1,Pass,20,110
199600311,1996,1,2,ALAMEDA,1996-11-05,PLEASANTON,0,M,DD,"Shall the Pacific Locomotive Association's excursion train, currently operating between Niles and Sunol on the first and third Sundays of the month, be permitted to extend its operations to Downtown Pleasanton with the Pleasanton Railroad Association and the Pacific Locomotive Association being soley responsible for the funding, construction and completing this project at no cost the City of Pleasanton?",70,70,Ordinance,200,60,Transport,17707,5930,23637,0.7491221390193341,M,1,Pass,0,199600310,17707,5930,23637,0.7491221390193341,1,Pass,70,60
199600312,1996,1,2,ALAMEDA,1996-11-05,PLEASANTON,0,M,EE,Shall an ordinance be adopted to limit a councilmember to two consecutive terms of four years each and to limit a mayor to four consecutive terms of two years each?,70,70,Ordinance,45,45,Governance: Political Reform/Term Limits,16012,7364,23376,0.6849760438056126,M,1,Pass,0,199600311,16012,7364,23376,0.6849760438056126,1,Pass,70,40
199600313,1996,1,2,ALAMEDA,1996-11-05,PLEASANTON,0,M,FF,Shall the Pleasanton Urban Growth Boundary Initiative be adopted to require voter approval of all but minor changes to the City's Urban Growth Boundary?,40,40,Initiative,21,21,Land Use: Growth Cap/Boundary,17435,5803,23238,0.750279714261124,M,1,Pass,0,199600312,17435,5803,23238,0.750279714261124,1,Pass,40,20
199600314,1996,1,2,ALAMEDA,1996-11-05,PLEASANTON,0,M,GG,"Shall the Pleasanton Residential Buildout Initiative be adopted which provides that the maximum number of residential units at buildout shall not exceed 29,000 units and cannot be changed except by a vote of the people?",40,40,Initiative,21,21,Land Use: Growth Cap/Boundary,17388,5710,23098,0.7527924495627327,M,1,Pass,0,199600313,17388,5710,23098,0.7527924495627327,1,Pass,40,20
199600315,1996,1,2,ALAMEDA,1996-11-05,UNION CITY,0,M,HH,Shall the City of Union City enact an ordinance limiting the number of terms the Mayor and Member of City Council may serve to three (3) consecutive terms in each office?,70,70,Ordinance,45,45,Governance: Political Reform/Term Limits,10727,2567,13294,0.8069053708439897,M,1,Pass,0,199600314,10727,2567,13294,0.8069053708439897,1,Pass,70,40
199600316,1996,1,2,ALAMEDA,1996-11-05,UNION CITY,0,M,II,"Shall the proposed ordinance which reaffirms and readopts Chapter IV ""Development Policies"" of the Hillside Area Plan (a portion of the Union City General Plan) containing fifty-three (53) development policies for the Hillside Area and which prohibits the amendment thereof without voter approval be adopted?",70,70,Ordinance,22,22,Land Use: Zoning,7950,4498,12448,0.6386568123393316,M,1,Pass,0,199600315,7950,4498,12448,0.6386568123393316,1,Pass,70,20
199600317,1996,4,2,BUTTE,1996-11-05,CHICO,0,M,H,Shall the smoking regulations of the City of Chico be amended to prohibit smoking in bars?,70,70,Ordinance,200,200,Other,10715,8651,19366,0.553289269854384,M,1,Pass,0,199600316,10715,8651,19366,0.553289269854384,1,Pass,70,200
199600318,1996,4,2,BUTTE,1996-11-05,CHICO,0,M,I,Shall the Chico City Charter be amended to permit the City Council to hold special municipal elections by mailed ballot?,20,20,Charter Amendment,48,48,Governance: Elections,9994,7797,17791,0.5617447023776067,M,1,Pass,0,199600317,9994,7797,17791,0.5617447023776067,1,Pass,20,40
199600319,1996,4,2,BUTTE,1996-11-05,CHICO,0,M,J,Shall the Chico City Charter be amended to delete the requirement that the City Clerk call the roll at City Council meetings?,20,20,Charter Amendment,40,40,Governance,5679,11725,17404,0.3263042978625603,M,2,Fail,0,199600318,5679,11725,17404,0.3263042978625603,2,Fail,20,40
199600320,1996,4,2,BUTTE,1996-11-05,CHICO,0,M,K,"Shall section 1006.1 of the Chico City Charter be amended to provide that all of the powers of the Bidwell Park and Playground Commission regarding the City's parks, playgrounds and street trees shall be carried out only in the manner and subject to the terms and conditions set forth by ordinance of the City Council?",20,20,Charter Amendment,51,51,Environment: Parks/Recreation,7960,8989,16949,0.4696442267980412,M,2,Fail,0,199600319,7960,8989,16949,0.4696442267980412,2,Fail,20,50
199600321,1996,4,2,BUTTE,1996-11-05,CHICO,0,M,L,Shall the Chico City Charter be amended to provide that all of the powers of the Airport Commission to maintain and operate the airport and airport property shall be carried out only in the manner and subject to the terms and conditions set forth by ordinance of the City Council?,20,20,Charter Amendment,61,61,Transport: Mass Transit,7971,8888,16859,0.47280384364434425,M,2,Fail,0,199600320,7971,8888,16859,0.47280384364434425,2,Fail,20,60
199600322,1996,4,2,BUTTE,1996-11-05,CHICO,0,M,M,Shall the Chico City Charter be amended to change the date by which the annual audit is to be submitted to the City Council from December 1 of each year to the date of the first regular City Council meeting in February?,20,20,Charter Amendment,40,40,Governance,10917,5609,16526,0.6605954253902941,M,1,Pass,0,199600321,10917,5609,16526,0.660595425390294,1,Pass,20,40
199600323,1996,4,2,BUTTE,1996-11-05,OROVILLE,0,M,N,"Shall Section 4 of Article VII of the City Charter entitled ""ORDINANCES"", be amended to provide that ordinances be published once in a newspaper of general circulation printed and published in the County of Butte and circulated in the City, along with procedures for publication of a summary of an ordinance, the amendment to read as stated in Resolution No. 5097 adopted by the City Council June 16, 1996 and on file in the City Clerk's Office?",20,20,Charter Amendment,40,40,Governance,1733,994,2727,0.6354968830216355,M,1,Pass,0,199600322,1733,994,2727,0.6354968830216355,1,Pass,20,40
199600324,1996,4,2,BUTTE,1996-11-05,OROVILLE,0,M,O,"Shall Section 1 of Article XVII of the City Charter, entitled ""CHIEF OF POLICE"", be amended to provide that convicted persons may be confined in the Butte County jail, rather than the City Jail, and to eliminate references to gender, the amendment to read as stated in Resolution No. 5097 adopted by the City Council June 16, 1996 and on file in the City Clerk's Office?",20,20,Charter Amendment,32,32,Safety: Police,2008,750,2758,0.7280638143582308,M,1,Pass,0,199600323,2008,750,2758,0.7280638143582306,1,Pass,20,30
199600325,1996,4,2,BUTTE,1996-11-05,PARADISE,0,M,P,Shall the Ordinance imposing an increase of the existing transient occupancy tax on the guest of hotels within Paradise from six percent to ten percent for general municipal purposes be approved?,2,2,Business Tax,100,100,General Services,5551,6165,11716,0.4737965175827928,M,2,Fail,0,199600324,5551,6165,11716,0.4737965175827928,2,Fail,1,100
199600326,1996,5,2,CALAVERAS,1996-11-05,ANGELS,0,M,A,Shall the Redevelopment Plan for the City of Angels Redevelopment Project be approved?,30,30,Advisory,20,20,Land Use,411,778,1189,0.3456686291000841,M,2,Fail,0,199600325,411,778,1189,0.3456686291000841,2,Fail,30,20
199600327,1996,5,2,CALAVERAS,1996-11-05,ANGELS,0,M,B,"Shall the City of Angels be authorized to levy an assessment to generate approximately $350,000.00 over a seen (7) year period for the purpose of obtaining fire suppression equipment and apparatus?",3,3,Property Tax,33,33,Safety: Fire,536,675,1211,0.4426094137076796,M,2,Fail,0,199600326,536,675,1211,0.4426094137076796,2,Fail,1,30
199600328,1996,7,2,CONTRA COSTA,1996-11-05,BRENTWOOD,0,M,F,"If an incumbent council member runs for the office of Mayor in this election and is elected, shall the City Council appoint the Council candidate who receives the highest number of votes and is not elected to fill the resulting Council vacancy?",70,70,Ordinance,48,48,Governance: Elections,3067,1442,4509,0.6801951652251055,M,1,Pass,0,199600327,3067,1442,4509,0.6801951652251054,1,Pass,70,40
199600329,1996,7,2,CONTRA COSTA,1996-11-05,EL CERRITO,0,M,G,"Shall Ordinance No. 96-9 be enacted, thereby approving the assessment first adopted in 1988, to provide a dedicated and secure source of funds for the maintenance of park facilities, street lighting and landscaping, fixed at the current rate of $72.00 per single family home (and proportionate rates for other land uses)?",3,3,Property Tax,73,73,Facilities: Museum/Cultural/Comm Ctrs,7103,3550,10653,0.6667605369379518,M,1,Pass,0,199600328,7103,3550,10653,0.6667605369379518,1,Pass,1,70
199600330,1996,7,2,CONTRA COSTA,1996-11-05,EL CERRITO,0,M,H,"Shall Ordinance No. 96-8 be approved, confirming the levy of an annual City-wide fire suppression assessment, as authorized by State law, in the yearly amount of $125.00 for a single family residence, and proportionate amounts for other property uses, to provide dedicated and stable funding for the provision of fire hazard abatement and fire-fighting services in the City of El Cerrito?",3,3,Property Tax,33,33,Safety: Fire,4336,6229,10565,0.4104117368670137,M,2,Fail,0,199600329,4336,6229,10565,0.4104117368670137,2,Fail,1,30
199600331,1996,7,2,CONTRA COSTA,1996-11-05,EL SOBRANTE,0,M,B,"Shall Contra Costa Supervisors Resolution No. 96/352 be enacted to create and maintain parks, trails, landscaping of roads and planting trees in unincorporated El Sobrante, by authorizing an annual assessment of a maximum of $30 per single family parcel (and higher assessments for commercial property) subject to the Board of Supervisors setting the assessment each year (not to exceed $30 per year, per single family parcel) with all assessments spent only in unincorporated El Sobrante?",30,30,Advisory,51,51,Environment: Parks/Recreation,2163,2393,4556,0.4747585601404741,M,2,Fail,0,199600330,2163,2393,4556,0.4747585601404741,2,Fail,30,50
199600332,1996,7,2,CONTRA COSTA,1996-11-05,PACHECO,0,M,C,"Shall Contra Costa Supervisor's Resolution 96/376 be enacted to authorize a per year assessment of $30 per single family parcel and 1/2 mobile home space (both subject to qualified senior citizens rate reductions) to 3 times (commercial property) that rate to provide needed Pacheco area park and landscape improvements including a linear park along Aspen Drive and Grayson Creek and beautification sites along Pacheco Boulevard, Marsh Drive and Center Avenue corridors and related park projects?",3,3,Property Tax,51,51,Environment: Parks/Recreation,660,684,1344,0.49107142857142855,T,2,FailT,0,199600331,660,684,1344,0.49107142857142855,2,FailT,1,50
199600333,1996,7,2,CONTRA COSTA,1996-11-05,PITTSBURG,0,M,I,"If Proposition 218, the 'Right to Vote on Taxes Act' is approved by California voters on November 5, 1996, then beginning July 1, 1997, and thereafter, should the City of Pittsburg continue to impose assessments not to exceed their present levels in the Citywide Landscaping and Lighting District 1988-01, for the purpose of improving, maintaining and beautifying the landscaping and lighting of city parks and facilities, medians, rights of way and streets?",3,3,Property Tax,74,73,Facilities: Museum/Cultural/Comm Ctrs,9081,4225,13306,0.6824740718472869,M,1,Pass,0,199600332,9081,4225,13306,0.6824740718472869,1,Pass,1,70
199600334,1996,7,2,CONTRA COSTA,1996-11-05,SAN PABLO,0,M,J,"Shall Ordinance 96-005 be enacted, confirming and approving the existing assessment in the San Pablo Street Lighting and Landscaping District (formed in 1982) at its current rate, and providing a dedicated funding source to continue maintenance of park and recreational facilities such as Davis Park and the Senior Center; and street lighting, landscaping and removal of graffiti and debris from City streets?",3,3,Property Tax,74,73,Facilities: Museum/Cultural/Comm Ctrs,3528,984,4512,0.7819148936170213,M,1,Pass,0,199600333,3528,984,4512,0.7819148936170213,1,Pass,1,70
199600335,1996,7,2,CONTRA COSTA,1996-11-05,SAN RAMON,0,M,K,"Shall the City of San Ramon continue to levy under the Landscaping and Lighting Act for maintenance of landscaped roadway medians, roadside areas, street lighting and other work allowed under the Act an annual City-wide assessment of $53 per single family residential parcel for fiscal year 1997-98 and $59 per such parcel for fiscal years 1998-99 and beyond and for other land uses those amounts computed in accord with the 196-97 Engineer's Report?",3,3,Property Tax,74,73,Facilities: Museum/Cultural/Comm Ctrs,11720,5095,16815,0.696996729110913,M,1,Pass,0,199600334,11720,5095,16815,0.6969967291109129,1,Pass,1,70
199600336,1996,10,2,FRESNO,1996-11-05,COALINGA,0,M,C,Advisory Measure:  Shall the City Council of the City of Coalinga actively pursue the construction of a second State prison to be located in the vicinity of the City of Coalinga?,30,30,Advisory,31,31,Safety: Jails/Courts,1476,1067,2543,0.5804168305151396,M,1,Pass,0,199600335,1476,1067,2543,0.5804168305151396,1,Pass,30,30
199600337,1996,10,2,FRESNO,1996-11-05,FOWLER,0,M,D,"An ordinance amending Chapter 6, of Title 3 of the Fowler Municipal Code pertaining to transient occupancy taxes and calling for an election pursuant to government code section 53724 on whether the transient occupancy tax shall be increased from four percent to ten percent.",2,2,Business Tax,200,112,Revenues: Tax Creation/Incr./Contin.,301,299,600,0.5016666666666667,M,1,Pass,0,199600336,301,299,600,0.5016666666666667,1,Pass,1,110
199600338,1996,10,2,FRESNO,1996-11-05,FRESNO,0,M,E,"To amend Section 600 of the Charter to allow alteration necessary to correct a typographical error or clerical error or omission only, to be performed by the City Clerk with the written approval and concurrence of the City attorney.",20,20,Charter Amendment,40,40,Governance,64076,23400,87476,0.7324980566098129,M,1,Pass,0,199600337,64076,23400,87476,0.7324980566098129,1,Pass,20,40
199600339,1996,10,2,FRESNO,1996-11-05,FRESNO,0,M,F,"To amend the Charter of the City of Fresno, Section 1210 regarding temporary loans to read that the aggregate amount of such loans at any time outstanding shall not exceed the amount authorized by applicable federal and California.",20,20,Charter Amendment,40,40,Governance,42091,39788,81879,0.514063435068821,M,1,Pass,0,199600338,42091,39788,81879,0.514063435068821,1,Pass,20,40
199600340,1996,10,2,FRESNO,1996-11-05,FRESNO,0,M,G,"To amend the Charter of the City of Fresno to read that no person elected to the office of Councilmember or Mayor for two successive terms shall again be eligible to hold that same office until one full term has intervened, applying to terms to which persons had been elected or appointed after May, 1985.",20,20,Charter Amendment,45,45,Governance: Political Reform/Term Limits,53750,35815,89565,0.6001228158320773,M,1,Pass,0,199600339,53750,35815,89565,0.6001228158320773,1,Pass,20,40
199600341,1996,10,2,FRESNO,1996-11-05,ORANGE COVE,0,M,H,"Should the City of Orange Cove have a Utility Users' Tax?  If adopted, that rate of this tax shall be seven percent of the charge to the customer of utility service and shall apply to each of the following utilities:  intrastate telephone services (other than that of a telephone corporation using such services); electrical energy services; natural gas delivered through mains of pipes (other than such services to a gas corporation or electrical corporation).",5,5,Utility Tax,200,112,Revenues: Tax Creation/Incr./Contin.,553,389,942,0.5870488322717622,T,2,FailT,0,199600340,553,389,942,0.5870488322717622,2,FailT,1,110
199600342,1996,10,2,FRESNO,1996-11-05,PARLIER,0,M,I,"For purposes of raising revenue to be used to maintain needed City services (for example, police, fire, recreation, youth and senior programs, etc.) for the citizens of Parlier, shall the City Council of the City of Parlier adopt a 7% general utility users tax, applicable to the use of electricity, natural gas, telephone and cable TV?",5,5,Utility Tax,100,112,Revenues: Tax Creation/Incr./Contin.,795,467,1262,0.6299524564183835,M,1,Pass,0,199600341,795,467,1262,0.6299524564183835,1,Pass,1,110
199600343,1996,10,2,FRESNO,1996-11-05,REEDLEY,0,M,J,"For purposes of raising revenue to be used for enhancing and expanding city police and fire protection services to the citizens of the City of Reedley, shall the City Council of the City of Reedley adopt a 3% utility users tax, applicable to the use of electricity, natural gas and telephone, for a period of not to exceed six (6) years?",5,5,Utility Tax,34,34,Safety: Multiple Emergency Services,3122,999,4121,0.7575831108954139,T,1,PassT,0,199600342,3122,999,4121,0.7575831108954137,1,PassT,1,30
199600344,1996,11,2,GLENN,1996-11-05,WILLOWS,0,M,F,Shall the office of City Clerk be appointive?,70,70,Ordinance,42,42,Governance: Personnel/Labor Relations,1019,746,1765,0.5773371104815864,M,1,Pass,0,199600343,1019,746,1765,0.5773371104815864,1,Pass,70,40
199600345,1996,12,2,HUMBOLDT,1996-11-05,ARCATA,0,M,N,"Shall the City of Arcata adopt a utility users tax (Resolution No. 957-06) which shall impose a three percent (3%) general tax on the use of certain utility services which shall go into effect December 1, 196, at which time the City's current three percent utility users tax (Ordinance 1209) shall be repealed?",5,5,Utility Tax,200,112,Revenues: Tax Creation/Incr./Contin.,4388,3619,8007,0.5480204820781815,T,2,FailT,0,199600344,4388,3619,8007,0.5480204820781815,2,FailT,1,110
199600346,1996,12,2,HUMBOLDT,1996-11-05,FORTUNA,0,M,O,Shall the Charter for the City of Fortuna be adopted?  The Proposed Charter is on file in the office of the City Clerk and may be obtained free of charge.,20,20,Charter Amendment,43,43,Governance: Organization,2628,1202,3830,0.6861618798955614,M,1,Pass,0,199600345,2628,1202,3830,0.6861618798955613,1,Pass,20,40
199600347,1996,13,2,IMPERIAL,1996-11-05,CALEXICO,0,M,E,Shall the 1/2 cent sales tax imposed for the benefit of the Calexico Hospital be terminated immediately following the satisfaction of the new bankruptcy debt repayment bonds issued by the Calexico Special Financing Authority (JPA)?,4,4,Sales Tax,72,72,Facilities: Health Facilities,2092,1302,3394,0.6163818503241013,M,1,Pass,0,199600346,2092,1302,3394,0.6163818503241013,1,Pass,1,70
199600348,1996,13,2,IMPERIAL,1996-11-05,WESTMORELAND,0,M,D,"Shall the ordinance which provides for a five (5) percent telephone, electricity, gas and cable television users' tax be enacted?",5,5,Utility Tax,100,112,Revenues: Tax Creation/Incr./Contin.,64,266,330,0.19393939393939394,M,2,Fail,0,199600347,64,266,330,0.19393939393939394,2,Fail,1,110
199600349,1996,15,2,KERN,1996-11-05,CALIFORNIA CITY,0,M,M,"Shall the City of California City be authorized to levy an assessment for fire suppression and panic hazard purposes in accordance with the report of the City Engineer dated July 2, 1996, and generally as follows:  1. Each unimproved lot or parcel - $19.00/year.  2. Each improved lot or parcel used for residential purposes - $21.09/year.  3. Each improved lot or parcel used for purposes other than residential purposes - $22.42/year?",3,3,Property Tax,33,33,Safety: Fire,1229,1552,2781,0.4419273642574613,T,2,FailT,0,199600348,1229,1552,2781,0.4419273642574613,2,FailT,1,30
199600350,1996,16,2,KINGS,1996-11-05,AVENAL,0,M,A,Shall the office of the City Clerk be appointive?,70,70,Ordinance,42,42,Governance: Personnel/Labor Relations,422,362,784,0.5382653061224489,M,1,Pass,0,199600349,422,362,784,0.5382653061224489,1,Pass,70,40
199600351,1996,16,2,KINGS,1996-11-05,AVENAL,0,M,B,Shall the office of City Treasurer be appointive?,70,70,Ordinance,42,42,Governance: Personnel/Labor Relations,402,378,780,0.5153846153846153,M,1,Pass,0,199600350,402,378,780,0.5153846153846153,1,Pass,70,40
199600352,1996,17,2,LAKE,1996-11-05,CLEARLAKE,0,M,T,Should Clearlake Ordinance No. ORD-65-95 be enacted to change the name of City of Clearlake to the City of Clearlake Highlands?,70,70,Ordinance,200,40,Governance,1160,2528,3688,0.31453362255965295,M,2,Fail,0,199600351,1160,2528,3688,0.31453362255965295,2,Fail,70,40
199600353,1996,19,2,LOS ANGELES,1996-11-05,AGOURA HILLS,0,M,L,"Shall an ordinance, of the City of Agoura Hills be adopted authorizing the City Council to establish the rate of the transient occupance tax at a rate not to exceed twelve percent (12%) of the rent charge for a hotel room?",2,2,Business Tax,100,112,Revenues: Tax Creation/Incr./Contin.,5496,2669,8165,0.6731169626454379,M,1,Pass,0,199600352,5496,2669,8165,0.6731169626454379,1,Pass,1,110
199600354,1996,19,2,LOS ANGELES,1996-11-05,ARCADIA,0,M,M,"Shall the Ordinance, which amends Section 25g of the Land Use element of the 1990 Arcadia General Plan to preclude any use other than horse racing in the ""horse racing"" designation, except by a majority vote of the people, be adopted?",70,70,Ordinance,22,22,Land Use: Zoning,6349,11705,18054,0.3516672205605406,M,2,Fail,0,199600353,6349,11705,18054,0.3516672205605406,2,Fail,70,20
199600355,1996,19,2,LOS ANGELES,1996-11-05,ARTESIA,0,M,N,Shall Ordinance 537 be adopted to validate and reenact the utility users tax at a rate not to exceed 2%?,5,5,Utility Tax,100,112,Revenues: Tax Creation/Incr./Contin.,1420,1661,3081,0.4608893216488153,M,2,Fail,0,199600354,1420,1661,3081,0.4608893216488153,2,Fail,1,110
199600356,1996,19,2,LOS ANGELES,1996-11-05,AVALON,0,M,O,Shall the business license tax ordinance requirement that the City turn over all business license taxes to the Chamber of Commerce be changed to require that all of these tax revenues go into the City's General Services Fund?,2,2,Business Tax,100,115,Revenues: Revenue Use,442,649,1091,0.40513290559120074,T,2,FailT,0,199600355,442,649,1091,0.40513290559120074,2,FailT,1,110
199600357,1996,19,2,LOS ANGELES,1996-11-05,AVALON,0,M,P,Shall the business license tax ordinance requirement that the City turn over all business license taxes to the Chamber of Commerce be changed to split these tax revenues evenly (50/50) between the City's General Services Fund and the Chamber of Commerce?,2,2,Business Tax,100,115,Revenues: Revenue Use,533,537,1070,0.49813084112149536,M,2,Fail,0,199600356,533,537,1070,0.4981308411214953,2,Fail,1,110
199600358,1996,19,2,LOS ANGELES,1996-11-05,AVALON,0,M,Q,Shall the business license tax ordinance be amended to increase the base rate business license tax from $93.75 to $120 and apply the base rate to businesses engaged in the transient rental of rooms and units be adopted?,2,2,Business Tax,200,112,Revenues: Tax Creation/Incr./Contin.,537,563,1100,0.48818181818181816,T,2,FailT,0,199600357,537,563,1100,0.48818181818181816,2,FailT,1,110
199600359,1996,19,2,LOS ANGELES,1996-11-05,DOWNEY,0,M,U,"Shall numerous sections of the Charter of the City of Downey be amended, as specifically set forth in Charter Amendment No. 10, to make certain textual changes to the Charter, to update the Charter to conform to changes in State law applicable to charter cities, to change certain procedures for the conduct of City business, and to clarify certain Charter provisions?",20,20,Charter Amendment,40,40,Governance,18273,6144,24417,0.7483720358766434,M,1,Pass,0,199600358,18273,6144,24417,0.7483720358766434,1,Pass,20,40
199600360,1996,19,2,LOS ANGELES,1996-11-05,INGLEWOOD,0,M,X,Shall various elected provisions of the Inglewood City Charter be amended in order to being them into conformity with changes in State law and remove ambiguities relating thereto?,20,20,Charter Amendment,40,40,Governance,14518,7830,22348,0.6496330767853946,M,1,Pass,0,199600359,14518,7830,22348,0.6496330767853946,1,Pass,20,40
199600361,1996,19,2,LOS ANGELES,1996-11-05,INGLEWOOD,0,M,Y,Shall various provisions of the Inglewood City Charter be amended to more explicitly set forth the duties of the Mayor and City Council and to establish a method for determining the compensation therefor?,20,20,Charter Amendment,42,42,Governance: Personnel/Labor Relations,13315,8892,22207,0.5995857162156077,M,1,Pass,0,199600360,13315,8892,22207,0.5995857162156077,1,Pass,20,40
199600362,1996,19,2,LOS ANGELES,1996-11-05,LONG BEACH,0,M,Z,"Shall the Long Beach City Council be authorized to finance a 911 Emergency Response System by the issuance of up to $30,000,000 in a special tax bonds, the levy of an annual special tax, and the establishment of an annual appropriations limit, all in respect of its Community Facilities District No. 4, as set forth in its Resolution Nos. C-26059 and C-26060?",13,13,Mello/Roos Bond,34,34,Safety: Multiple Emergency Services,62700,46139,108839,0.5760802653460616,T,2,FailT,0,199600361,62700,46139,108839,0.5760802653460616,2,FailT,10,30
199600363,1996,19,2,LOS ANGELES,1996-11-05,LOS ANGELES,0,M,D,FIRE AND POLICE PENSIONS-SURVIVING SOUSES.  Shall the Charter be amended to change the definition of a qualified surviving spouse so that such spouse will not lose his or her pension benefit on remarriage?,20,20,Charter Amendment,41,41,Governance: Benefits/Compensation,485465,261693,747158,0.6497487813822511,M,1,Pass,0,199600362,485465,261693,747158,0.6497487813822511,1,Pass,20,40
199600364,1996,19,2,LOS ANGELES,1996-11-05,LOS ANGELES,0,M,E,"APPOINTMENT OF MEMBERS OF THE CITY ETHICS COMMISSION; SELECTION OF THE COMMISSION PRESIDENT.  Shall the City of Los Angeles Charter be amended to provide that the Mayor, City Attorney, Controller, President of the Council and President Pro Tem of the Council will each appoint a member to the City Ethics Commission, and that the Commission will choose its own President and Vice President?",20,20,Charter Amendment,45,45,Governance: Political Reform/Term Limits,392093,277789,669882,0.5853165184316044,M,1,Pass,0,199600363,392093,277789,669882,0.5853165184316044,1,Pass,20,40
199600365,1996,19,2,LOS ANGELES,1996-11-05,LOS ANGELES,0,M,F,"CITY EMPLOYEES' RETIREMENT SYSTEM-RULES CONCERNING MEMBER CONTRIBUTIONS, VESTING AND ADMINISTRATION OF SUPPLEMENTAL RETIREMENT PLANS.  Shall the Charter be amended to permit the City Employees' Retirement System (CERS) to automatically refund or vest retirement contributions upon termination of employment, eliminate cost of living reductions from members' contributions, remove the guardianship requirement for a natural or adoptive parent and administer supplemental or alternative retirement plans?",20,20,Charter Amendment,41,41,Governance: Benefits/Compensation,418078,243450,661528,0.6319883663276535,M,1,Pass,0,199600364,418078,243450,661528,0.6319883663276535,1,Pass,20,40
199600366,1996,19,2,LOS ANGELES,1996-11-05,LOS ANGELES,0,M,G,AUTHORIZE THE CITY COUNCIL TO PERMIT THE DEPARTMENT OF WATER AND POWER TO OFFER PRODUCTS AND SERVICES INSIDE OR OUTSIDE CITY AND NEGOTIATE ELECTRIC RATE CONTRACTS.  Shall the City of Los Angeles Charter be amended to permit the Department of Water and Power to engage in any lawful business enterprise inside or outside the City that does not interfere with providing water and power to its customers and negotiate electric rate contracts?,20,20,Charter Amendment,200,100,General Services,451124,250972,702096,0.6425389120576104,M,1,Pass,0,199600365,451124,250972,702096,0.6425389120576104,1,Pass,20,100
199600367,1996,19,2,LOS ANGELES,1996-11-05,LOS ANGELES,0,M,I,"ESTABLISHING UNIFORM STREAMLINED SALE AND ISSUANCE OF BONDS PROCEDURES FOR, AND REQUIRING PERIODIC INDEPENDENT SURVEYS OF , PROPRIETARY DEPARTMENTS.  Shall the City of Los Angeles Charter be amended to establish uniform streamlined procedures for the sale and issuance of bonds by, and to require periodic independent surveys of the business and property of, the Harbor Department and the Departments of Water and Power and Airports?",20,20,Charter Amendment,42,42,Governance: Personnel/Labor Relations,456921,210910,667831,0.6841865681587109,M,1,Pass,0,199600366,456921,210910,667831,0.6841865681587108,1,Pass,20,40
199600368,1996,19,2,LOS ANGELES,1996-11-05,LOS ANGELES,0,M,J,CIVIL SERVICE EXEMPTIONS FOR MANAGEMENT AND PROFESSIONAL EMPLOYEES.  Shall the City of Los Angeles Charter be amended to allow the City Council to exempt from civil service up to 15 positions in the Department of Water and Power and up to 150 persons in other City departments combined for management or professional services where vacancies cannot be filled through civil service and requirements for each position are established by Council by 2/3/ vote?,20,20,Charter Amendment,42,42,Governance: Personnel/Labor Relations,386677,291124,677801,0.5704875029691606,M,1,Pass,0,199600367,386677,291124,677801,0.5704875029691606,1,Pass,20,40
199600369,1996,19,2,LOS ANGELES,1996-11-05,LOS ANGELES,0,M,K,"CITY-WIDE PARKS, RECREATION AND COMMUNITY FACILITIES ASSESSMENT.  Shall an ordinance be adopted creating a city-wide assessment district to provide for increased funding for the acquisition and improvement of parks, recreation and community facilities for use by children and others city-wide, through an assessment on real property at a levy of approximately $25 million yearly for 30 years?",3,3,Property Tax,51,51,Environment: Parks/Recreation,366446,363632,730078,0.5019271913411991,M,1,Pass,0,199600368,366446,363632,730078,0.5019271913411991,1,Pass,1,50
199600370,1996,19,2,LOS ANGELES,1996-11-05,RANCHO PALOS VERDES CITY,0,M,CC,Shall Ordinance CC be adopted to validate and continue the collection of the existing 3% utility users tax?,5,5,Utility Tax,100,112,Revenues: Tax Creation/Incr./Contin.,9481,8970,18451,0.513847487941033,M,1,Pass,0,199600369,9481,8970,18451,0.513847487941033,1,Pass,1,110
199600371,1996,19,2,LOS ANGELES,1996-11-05,SAN MARINO,0,M,DD,Shall Ordinance No. 096-1099 be adopted to reenact and validate the collection of the utility user tax at a rate not to exceed 6%?,5,5,Utility Tax,100,112,Revenues: Tax Creation/Incr./Contin.,3728,1772,5500,0.6778181818181819,M,1,Pass,0,199600370,3728,1772,5500,0.6778181818181818,1,Pass,1,110
199600372,1996,19,2,LOS ANGELES,1996-11-05,SANTA MONICA,0,M,EE,"Shall the City of Santa Monica incur general obligation bonded indebtedness in the principal amount of not to exceed $29.5 Million for the acquisition and construction of a Public Safety Building and certain related parking, street, utility and other improvements?",11,11,GO Bond,34,34,Safety: Multiple Emergency Services,21048,12692,33740,0.6238292827504446,T,2,FailT,0,199600371,21048,12692,33740,0.6238292827504446,2,FailT,10,30
199600373,1996,19,2,LOS ANGELES,1996-11-05,SIERRA MADRE,0,M,FF,"Shall ordinance no. I-96-1 entitled ""An ordinance of the people of Sierra Madre, validating, re-enacting and extending indefinitely a utility user tax at the same rate currently set forth in Chapter 3.36 (Ordinance No. 1100) of the Sierra Madre Municipal Code"" be adopted?",5,5,Utility Tax,100,112,Revenues: Tax Creation/Incr./Contin.,3059,2423,5482,0.5580080262677855,M,1,Pass,0,199600372,3059,2423,5482,0.5580080262677855,1,Pass,1,110
199600374,1996,21,2,MARIN,1996-11-05,NOVATO,0,M,D,Shall the ordinance increasing the transient occupancy tax from 8% to 10% be adopted?,2,2,Business Tax,100,112,Revenues: Tax Creation/Incr./Contin.,9314,9517,18831,0.4946099516754288,M,2,Fail,0,199600373,9314,9517,18831,0.4946099516754288,2,Fail,1,110
199600375,1996,23,2,MENDOCINO,1996-11-05,FORT BRAGG,0,M,B,"Shall ordinance 789, an Ordinance imposing a transactions and use tax to be administered by the State Board of Equalization for repair, replacement, construction, reconstruction, or resurfacing of the City's streets and roads system and increasing the City's spending limit, be adopted?",4,4,Sales Tax,74,73,Facilities: Museum/Cultural/Comm Ctrs,993,1180,2173,0.4569719282098481,T,2,FailT,0,199600374,993,1180,2173,0.4569719282098481,2,FailT,1,70
199600376,1996,23,2,MENDOCINO,1996-11-05,FORT BRAGG,0,M,C,"Shall Ordinance 790, An Ordinance Prohibiting Oil and/or Gas Development and/or infrastructure within the City of Fort Bragg, be adopted?",70,70,Ordinance,24,24,Land Use: Private Projects,1400,787,2187,0.6401463191586649,M,1,Pass,0,199600375,1400,787,2187,0.6401463191586648,1,Pass,70,20
199600377,1996,26,2,MONO,1996-11-05,MAMMOTH LAKES,0,M,B,"Shall the Town of Mammoth Lakes, upon receipt of grant or other funding for affordable housing, be authorized to construct or acquire up to 200 units of low rent housing pursuant to Article 34 of the Constitution of the State of California?",70,70,Ordinance,81,81,Housing: Affordable,1060,796,1856,0.5711206896551724,M,1,Pass,0,199600376,1060,796,1856,0.5711206896551724,1,Pass,70,80
199600378,1996,26,2,MONO,1996-11-05,MAMMOTH LAKES,0,M,C,"Shall the ordinance entitled ""The Shady Rest Tract Land Use Initiative"" be adopted?",40,40,Initiative,22,22,Land Use: Zoning,851,1057,1908,0.44601677148846963,M,2,Fail,0,199600377,851,1057,1908,0.4460167714884696,2,Fail,40,20
199600379,1996,27,2,MONTEREY,1996-11-05,MONTEREY,0,M,D,"Shall Section 38-11A(c) of Appendix A to Article 8, Section 8.1 of the Monterey Charter be amended to permit the City to allow more than one hostel operated by a nonprofit agency in non single-family residential (R-1 or R-2 zones) with a conditional use permit approved by the City Council by ordinance?",20,20,Charter Amendment,22,22,Land Use: Zoning,6001,3533,9534,0.6294315082861338,M,1,Pass,0,199600378,6001,3533,9534,0.6294315082861338,1,Pass,20,20
199600380,1996,29,2,NEVADA,1996-11-05,GRASS VALLEY,0,M,L,Shall the Charter amendments as proposed for the City of Grass Valley be adopted?,20,20,Charter Amendment,40,40,Governance,1858,1102,2960,0.6277027027027027,M,1,Pass,0,199600379,1858,1102,2960,0.6277027027027027,1,Pass,20,40
199600381,1996,29,2,NEVADA,1996-11-05,NEVADA CITY,0,M,K,"Shall the City of Nevada City adopt an Ordinance limiting the City's ability to regulate the architecture, tree removal and landscaping of owner-occupied residences outside the Historical District?",70,70,Ordinance,24,24,Land Use: Private Projects,487,1074,1561,0.31197950032030747,M,2,Fail,0,199600380,487,1074,1561,0.31197950032030747,2,Fail,70,20
199600382,1996,30,2,ORANGE,1996-11-05,ANAHEIM,0,M,B,"Shall the City's transient occupancy tax, which is a tax only upon persons occupying hotel or motel rooms in Anaheim, be retained at the current rate, including the 2% amount implemented in 1995?  There will be an annual independent audit conducted of these revenues and the results report to the public in the newspaper.",2,2,Business Tax,100,112,Revenues: Tax Creation/Incr./Contin.,46840,16439,63279,0.7402139730400292,M,1,Pass,0,199600381,46840,16439,63279,0.7402139730400291,1,Pass,1,110
199600383,1996,30,2,ORANGE,1996-11-05,ANAHEIM,0,M,C,"Shall Section 511 of the City Charter be amended to not require the reading in full of any emergency ordinance at the City Council meeting at which such ordinance is to be considered, provided the full text of the ordinance is made available to the public for review prior to its consideration by the City Council?",20,20,Charter Amendment,40,40,Governance,32889,26138,59027,0.5571856946820947,M,1,Pass,0,199600382,32889,26138,59027,0.5571856946820947,1,Pass,20,40
199600384,1996,30,2,ORANGE,1996-11-05,ANAHEIM,0,M,D,"Shall Section 512 of the City Charter be amended to permit publication of a summary of any city ordinance adopted, as an alternative to publication of the full text of the ordinance?",20,20,Charter Amendment,40,40,Governance,34494,24542,59036,0.5842875533572736,M,1,Pass,0,199600383,34494,24542,59036,0.5842875533572736,1,Pass,20,40
199600385,1996,30,2,ORANGE,1996-11-05,BUENA PARK,0,M,E,Shall Ordinance No. 1330 of the City of Buena Park establishing term limits for members of the City Council be approved?,70,70,Ordinance,45,45,Governance: Political Reform/Term Limits,13632,3140,16772,0.8127832101120916,M,1,Pass,0,199600384,13632,3140,16772,0.8127832101120915,1,Pass,70,40
199600386,1996,30,2,ORANGE,1996-11-05,COSTA MESA,0,M,F,Should the City adopt an ordinance to add Section 2-24 to Chapter II of Title 2 of the Costa Mesa Municipal Code to read as follows:  Section 2-24.  Term Limits for Members of the City Council.  The number of terms a member of the City Council may serve on the City Council shall be limited to two(2) consecutive terms of four(4) years each.,70,70,Ordinance,45,45,Governance: Political Reform/Term Limits,22537,5816,28353,0.7948717948717949,M,1,Pass,0,199600385,22537,5816,28353,0.7948717948717948,1,Pass,70,40
199600387,1996,30,2,ORANGE,1996-11-05,CYPRESS,0,M,G,STORM DRAINAGE BOND MEASURE.  Shall the City of Cypress issue an estimated $10 million in General Obligation Bonds for the purpose of constructing and upgrading City-wide storm drain facilities to provide additional storm drain protection to Cypress residents?,11,11,GO Bond,74,73,Facilities: Museum/Cultural/Comm Ctrs,10108,5800,15908,0.6354035705305506,T,2,FailT,0,199600386,10108,5800,15908,0.6354035705305506,2,FailT,10,70
199600388,1996,30,2,ORANGE,1996-11-05,DANA POINT,0,M,H,Shall an Ordinance of the City of Dana Point be adopted limiting Council Members to two consecutive terms of office?,70,70,Ordinance,45,45,Governance: Political Reform/Term Limits,10975,2267,13242,0.8288022957257212,M,1,Pass,0,199600387,10975,2267,13242,0.8288022957257212,1,Pass,70,40
199600389,1996,30,2,ORANGE,1996-11-05,GARDEN GROVE,0,M,I,Shall an Ordinance which reduces by 15% the business license tax on businesses within the City and which continues the business license tax based on gross receipts adopted by the City Council in 1991 (as established by Title 5 of the Garden Grove Municipal Code) be adopted?,2,2,Business Tax,200,111,Revenues: Tax Repeal/Reduction/Limit,21982,12083,34065,0.6452957581094966,T,2,FailT,0,199600388,21982,12083,34065,0.6452957581094966,2,FailT,1,110
199600390,1996,30,2,ORANGE,1996-11-05,HUNTINGTON BEACH,0,M,J,ADVISORY VOTE ONLY.  Should the City of Huntington Beach construct: a sports field on an undeveloped portion of Huntington Central Park; athletic field lighting at high schools; a public gymnasium at Murdy Community Center; and fund youth sports field grants by establishing a ten year citywide assessment district for a total of $11.5 million at a maximum annual cost of $24 per single family residence; $10 per multi-family unit; and $5 per business and mobile home unit?,30,30,Advisory,47,47,Governance: Contracting/Bidding/Leasing,32064,36760,68824,0.46588399395559693,M,2,Fail,0,199600389,32064,36760,68824,0.4658839939555969,2,Fail,30,40
199600391,1996,30,2,ORANGE,1996-11-05,HUNTINGTON BEACH,0,M,K,"Shall the City of Huntington Beach at a cost of $1.83 million construct a gymnasium and related improvements and reconfigure existing parking at Murdy Community Center, east of Goldenwest Street, south of Norma Drive, to provide youth, adult and senior exercise classes, basketball, volleyball and other recreation/sports activities?",70,70,Ordinance,51,51,Environment: Parks/Recreation,33059,35727,68786,0.48060651876835403,M,2,Fail,0,199600390,33059,35727,68786,0.48060651876835403,2,Fail,70,50
199600392,1996,30,2,ORANGE,1996-11-05,HUNTINGTON BEACH,0,M,L,"Shall the City of Huntington Beach at a cost of $1.5 million construct lighted soccer and softball fields, a roller hockey and snack bar concession, parking, restrooms, and related improvements in an undeveloped portion of Huntington Central Park, south of Talbert Avenue and east of Goldenwest Street, on property that was formerly a landfill and mushroom farm?",70,70,Ordinance,51,51,Environment: Parks/Recreation,34604,34320,68924,0.5020602402646394,M,1,Pass,0,199600391,34604,34320,68924,0.5020602402646394,1,Pass,70,50
199600393,1996,30,2,ORANGE,1996-11-05,IRVINE,0,M,M,Shall Ordinance No. 95-10 of the City of Irvine be amended to increase the individual contribution limit by any person to any City candidate to $300 per election cycle as adjusted?,70,70,Ordinance,45,45,Governance: Political Reform/Term Limits,22279,17076,39355,0.5661034176089442,M,1,Pass,0,199600392,22279,17076,39355,0.5661034176089442,1,Pass,70,40
199600394,1996,30,2,ORANGE,1996-11-05,LA PALMA,0,M,O,"Shall Ordinance No. 96-02 of the City of La Palma, limiting the terms for members of the City Council to two consecutive terms, be adopted?",70,70,Ordinance,45,45,Governance: Political Reform/Term Limits,3993,1036,5029,0.7939948299860808,M,1,Pass,0,199600393,3993,1036,5029,0.7939948299860807,1,Pass,70,40
199600395,1996,30,2,ORANGE,1996-11-05,LAGUNA NIGUEL,0,M,N,"Shall an Ordinance be adopted which provides that a person is not eligible to hold office as a member of the City Council if that person has served in the office for two (2) consecutive terms, unless he or she has been out of office for at least two (2) years?",70,70,Ordinance,45,45,Governance: Political Reform/Term Limits,17199,4868,22067,0.7793991027325872,M,1,Pass,0,199600394,17199,4868,22067,0.7793991027325872,1,Pass,70,40
199600396,1996,30,2,ORANGE,1996-11-05,LOS ALAMITOS,0,M,P,"Shall Ordinance No. 601 entitled ""AN ORDINANCE OF THE PEOPLE OF THE CITY OF LOS ALAMITOS AMENDING SECTION 5.04.150 OF THE LOS ALAMITOS MUNICIPAL CODE BY REPEALING THE ANNUAL FIVE PERCENT INCREASE IN THE BUSINESS LICENSE TAX AND ADOPTING AN ANNUAL CONSUMER PRICE INDEX ADJUSTMENT TO THE BUSINESS LICENSE TAX"" be adopted?",2,2,Business Tax,200,110,Revenues,2672,991,3663,0.7294567294567295,T,1,PassT,0,199600395,2672,991,3663,0.7294567294567295,1,PassT,1,110
199600397,1996,30,2,ORANGE,1996-11-05,NEWPORT BEACH,0,M,Q,"Shall Initiative Ordinance 878 be amended to require the City of Newport Beach to use property tax revenue to pay only for the cost of providing curbside container refuse collection for existing or future residential unit within city boundaries as of November 1, 1996?",40,40,Initiative,200,115,Revenues: Revenue Use,17854,11825,29679,0.6015701337646147,M,1,Pass,0,199600396,17854,11825,29679,0.6015701337646147,1,Pass,40,110
199600398,1996,30,2,ORANGE,1996-11-05,ORANGE,0,M,R,Shall the City of Orange Council Members be limited to a maximum of two consecutive four-year terms and the elected Mayor be limited to a maximum of three consecutive two-year terms?,70,70,Ordinance,45,45,Governance: Political Reform/Term Limits,30485,6660,37145,0.8207026517700902,M,1,Pass,0,199600397,30485,6660,37145,0.8207026517700902,1,Pass,70,40
199600399,1996,30,2,ORANGE,1996-11-05,YORBA LINDA,0,M,S,Shall the Ordinance be adopted which ordains that a person is ineligible to hold office as a Member of the City Council if that person has served in the office for three (3) full terms?,70,70,Ordinance,45,45,Governance: Political Reform/Term Limits,15087,6906,21993,0.6859909971354522,M,1,Pass,0,199600398,15087,6906,21993,0.6859909971354522,1,Pass,70,40
199600400,1996,30,2,ORANGE,1996-11-05,YORBA LINDA,0,M,T,"Shall the Ordinance be adopted which ordains that a person is ineligible to hold office as a Member of the City Council if that person has served in the office for two (2) consecutive full terms, unless he or she has been out of the office for at least two (2) years, with no limitation on the total number of terms?",70,70,Ordinance,45,45,Governance: Political Reform/Term Limits,13008,8517,21525,0.6043205574912892,M,1,Pass,0,199600399,13008,8517,21525,0.6043205574912892,1,Pass,70,40
199600401,1996,31,2,PLACER,1996-11-05,AUBURN,0,M,P,Shall the office of City Clerk be appointive?,70,70,Ordinance,42,42,Governance: Personnel/Labor Relations,2130,3108,5238,0.4066437571592211,M,2,Fail,0,199600400,2130,3108,5238,0.4066437571592211,2,Fail,70,40
199600402,1996,31,2,PLACER,1996-11-05,AUBURN,0,M,Q,Shall the office of City Treasurer be appointive?,70,70,Ordinance,42,42,Governance: Personnel/Labor Relations,1951,3226,5177,0.37685918485609426,M,2,Fail,0,199600401,1951,3226,5177,0.37685918485609426,2,Fail,70,40
199600403,1996,31,2,PLACER,1996-11-05,AUBURN,0,M,R,Shall an ordinance amending Auburn Municipal Code section 3-7.03 to increase the Transient Occupancy Tax from 8 percent to 10 percent be approved?,2,2,Business Tax,100,112,Revenues: Tax Creation/Incr./Contin.,2352,2756,5108,0.46045418950665623,M,2,Fail,0,199600402,2352,2756,5108,0.46045418950665623,2,Fail,1,110
199600404,1996,31,2,PLACER,1996-11-05,LINCOLN,0,M,E,Shall the City of Lincoln establish a transient occupancy tax?,2,2,Business Tax,100,112,Revenues: Tax Creation/Incr./Contin.,988,1537,2525,0.3912871287128713,M,2,Fail,0,199600403,988,1537,2525,0.3912871287128713,2,Fail,1,110
199600405,1996,31,2,PLACER,1996-11-05,LINCOLN,0,M,S,Shall the City of Lincoln Establish a Community Center Facility Tax?,2,2,Business Tax,100,112,Revenues: Tax Creation/Incr./Contin.,359,2139,2498,0.14371497197758207,M,2,Fail,0,199600404,359,2139,2498,0.14371497197758207,2,Fail,1,110
199600406,1996,31,2,PLACER,1996-11-05,LOOMIS,0,M,N,"TRANSIENT OCCUPANCY TAX INCREASE.  Shall Ordinance No. 167 of the Town of Loomis, an ordinance ratifying and increasing the Town transient occupancy tax on patrons of hotels and motels (except for parking sites in campgrounds) from 3% to 10%, be approved?",2,2,Business Tax,100,112,Revenues: Tax Creation/Incr./Contin.,1157,1341,2498,0.4631705364291433,M,2,Fail,0,199600405,1157,1341,2498,0.4631705364291433,2,Fail,1,110
199600407,1996,31,2,PLACER,1996-11-05,ROCKLIN,0,M,H,"TRANSIENT OCCUPANCY TAX INCREASE.  Shall Ordinance No. 736, an ordinance amending Rocklin Municipal Code 5.240.30A to increase the Transient Occupancy Tax from 8% to 10% be approved?",2,2,Business Tax,100,112,Revenues: Tax Creation/Incr./Contin.,4440,4964,9404,0.47213951509995744,M,2,Fail,0,199600406,4440,4964,9404,0.47213951509995744,2,Fail,1,110
199600408,1996,31,2,PLACER,1996-11-05,ROSEVILLE,0,M,J,"Shall Section 4.24.030 A of the Roseville Municipal Code, relating to the amount of the Hotel Occupancy Tax, be amended to raise the amount of the tax charged to those who occupy a hotel room in Roseville from six percent (6.0%) to ten percent (10.0%) on the nightly room rental charged by the hotel operator?",2,2,Business Tax,100,112,Revenues: Tax Creation/Incr./Contin.,12250,12347,24597,0.4980282148229459,M,2,Fail,0,199600407,12250,12347,24597,0.4980282148229459,2,Fail,1,110
199600409,1996,31,2,PLACER,1996-11-05,ROSEVILLE,0,M,K,"Shall the Roseville General Plan, Zoning Ordinance and Municipal Code be amended to reduce residential densities of certain Roseville property owners, and to require approval by citywide election of any specific plan in any designated Urban Reserve Area, and require approval by citywide election of any exceptions to a traffic Level of Service ""C"" standard, while exempting major approved projects, and require the city to defend this initiative if adopted from any legal challenges?",70,70,Ordinance,22,22,Land Use: Zoning,7687,18013,25700,0.29910505836575874,M,2,Fail,0,199600408,7687,18013,25700,0.29910505836575874,2,Fail,70,20
199600410,1996,33,2,RIVERSIDE,1996-11-05,CATHEDRAL CITY,0,M,Y,"Shall the ordinance proposed by initiative petition implementing the Palm Hills Annexation Protection Plan, known as the Santa Rosa Open Space initiative, be approved and adopted?",70,70,Ordinance,23,23,Land Use: Open Space,2918,4565,7483,0.3899505545904049,M,2,Fail,0,199600409,2918,4565,7483,0.3899505545904049,2,Fail,70,20
199600411,1996,33,2,RIVERSIDE,1996-11-05,COCHELLA,0,M,Z,"Should the Coachella City Council have the ability to tax businesses, hotel guest and utility users?",2,2,Business Tax,100,112,Revenues: Tax Creation/Incr./Contin.,520,1481,2001,0.25987006496751625,M,2,Fail,0,199600410,520,1481,2001,0.25987006496751625,2,Fail,1,110
199600412,1996,33,2,RIVERSIDE,1996-11-05,DESERT HOT SPRINGS,0,M,CC,Shall the City eliminate Rancho del Oro assessment and levy an annual municipal services general excise tax (as outlined in Resolution 96-23)?,3,3,Property Tax,100,111,Revenues: Tax Repeal/Reduction/Limit,934,2030,2964,0.31511470985155193,M,2,Fail,0,199600411,934,2030,2964,0.31511470985155193,2,Fail,1,110
199600413,1996,33,2,RIVERSIDE,1996-11-05,DESERT HOT SPRINGS,0,M,DD,"Shall the City eliminate users utility tax, landscaping/lighting assessment, Rancho del Oro assessment, and levy an annual police services special excise tax (as outlined in Resolution 96-24)?",5,5,Utility Tax,100,111,Revenues: Tax Repeal/Reduction/Limit,1285,1662,2947,0.43603664743807263,M,2,Fail,0,199600412,1285,1662,2947,0.43603664743807263,2,Fail,1,110
199600414,1996,33,2,RIVERSIDE,1996-11-05,DESERT HOT SPRINGS,0,M,EE,Shall the City Council of the City of Desert Hot Springs establish a Police Commission to advise the City Council on matters concerning the funding of police services and establishing levels of law enforcement service in the City (as outlined in Resolution 96-21)?,30,30,Advisory,32,32,Safety: Police,1640,1333,2973,0.5516313488059199,M,1,Pass,0,199600413,1640,1333,2973,0.5516313488059199,1,Pass,30,30
199600415,1996,33,2,RIVERSIDE,1996-11-05,LA QUINTA,0,M,W,Shall the Charter be adopted making La Quinta a charter city so that the laws of La Quinta shall prevail over state law with respect to municipal affairs?,20,20,Charter Amendment,42,42,Governance: Personnel/Labor Relations,3073,2447,5520,0.5567028985507246,M,1,Pass,0,199600414,3073,2447,5520,0.5567028985507246,1,Pass,20,40
199600416,1996,33,2,RIVERSIDE,1996-11-05,MORENO VALLEY,0,M,AA,"Shall the ordinance entitled:  ""AN ORDINANCE OF THE CITY OF MORENO VALLEY, CALIFORNIA, REENACTING THE EXISTING 6% UTILITY USERS TAX OTHERWISE SUBJECT TO REPEAL AS OF DECEMBER 31, 1996"" be approved?",5,5,Utility Tax,100,112,Revenues: Tax Creation/Incr./Contin.,16149,14668,30817,0.52402894506279,M,1,Pass,0,199600415,16149,14668,30817,0.52402894506279,1,Pass,1,110
199600417,1996,33,2,RIVERSIDE,1996-11-05,MORENO VALLEY,0,M,BB,"Shall the ordinance entitled ""AN ORDINANCE OF THE CITY OF MORENO VALLEY, CALIFORNIA, REENACTING THE EXISTING BUSINESS LICENSE TAX OTHERWISE SUBJECT TO REPEAL AS OF DECEMBER 31, 1996"" be approved?",2,2,Business Tax,100,112,Revenues: Tax Creation/Incr./Contin.,16186,14483,30669,0.5277641918549676,M,1,Pass,0,199600416,16186,14483,30669,0.5277641918549676,1,Pass,1,110
199600418,1996,33,2,RIVERSIDE,1996-11-05,RANCHO MIRAGE,0,M,X,"Shall the City Council of Rancho Mirage be permitted to review, act on a settlement agreement including a land lease on terms and conditions acceptable to the City Council, and after proper land use application and review, allow Olympus Rancho Mirage P. L.. to develop a golf course on that land?",70,70,Ordinance,24,24,Land Use: Private Projects,3593,1644,5237,0.686079816688944,M,1,Pass,0,199600417,3593,1644,5237,0.686079816688944,1,Pass,70,20
199600419,1996,34,2,SACRAMENTO,1996-11-05,CITRUS HEIGHTS (PROPOSED CITY),0,M,R,"PROPOSED INCORPORATION OF THE CITY OF CITRUS HEIGHTS.  Shall the order adopted on July 23, 1996 by the Board of Supervisors ordering the incorporation of the territory described in the order and designated in the order as Incorporation of Citrus Heights, California (29-86/94) be confirmed subject to the terms and conditions including the annual payment from the City to the County of Sacramento of $5,621,000 commencing with a partial payment in 1996-1997 and terminating, as adjusted, after 2021-2022; and including authorization, as approved by the voters through this measure, for the City to continue to levy and collect within its territory the same general taxes, fees, charges, assessments and rates as presently levied and collected by the County of Sacramento, as more particularly described and set forth in the order?",70,70,Ordinance,44,44,Governance: Incorporation/Formation/Annexation,16833,10140,26973,0.6240685129574018,M,1,Pass,0,199600418,16833,10140,26973,0.6240685129574018,1,Pass,70,40
199600420,1996,34,2,SACRAMENTO,1996-11-05,FOLSOM,0,M,F,"To expand Lembi Park to provide indoor recreational facilities, swimming pools, and related facilities for children and adults of all ages, shall the City of Folsom issue $8.25 million of general obligation bonds?",11,11,GO Bond,51,51,Environment: Parks/Recreation,6737,8445,15182,0.443749176656567,T,2,FailT,0,199600419,6737,8445,15182,0.443749176656567,2,FailT,10,50
199600421,1996,34,2,SACRAMENTO,1996-11-05,FOLSOM,0,M,G,"To preserve, enhance and acquire park facilities, historic ranch land, and improve the City Zoo, shall the City of Folsom issue $9 million of general obligations bonds to enhance Humbug-Willow Creek Parkway Trails, acquire the Broder Cattle Ranch for future community use, provide for planned expansion at the Folsom City Zoo, acquire a site and construct a public gym north of the American River, and construct or renovate neighborhood parks throughout the city?",11,11,GO Bond,51,51,Environment: Parks/Recreation,7376,7889,15265,0.4831968555519162,T,2,FailT,0,199600420,7376,7889,15265,0.48319685555191616,2,FailT,10,50
199600422,1996,34,2,SACRAMENTO,1996-11-05,GALT,0,M,H,Shall Ordinance No. 96-09 of the City of Galt be approved so as to establish a special tax for Police Protection Services for a five year term?,2,2,Business Tax,32,32,Safety: Police,1543,2812,4355,0.35430539609644085,T,2,FailT,0,199600421,1543,2812,4355,0.35430539609644085,2,FailT,1,30
199600423,1996,34,2,SACRAMENTO,1996-11-05,ISLETON,0,M,I,"CITY OF ISLETON BUSINESS OPERATIONS TAXES.  Shall Ordinance No. 336 of the City of Isleton, an ordinance authorizing the City Council to impose various business operation taxes upon businesses operating in the City of Isleton, be approved?",2,2,Business Tax,100,112,Revenues: Tax Creation/Incr./Contin.,177,161,338,0.5236686390532544,M,1,Pass,0,199600422,177,161,338,0.5236686390532544,1,Pass,1,110
199600424,1996,34,2,SACRAMENTO,1996-11-05,ISLETON,0,M,J,"CITY OF ISLETON SHORT-TERM PARKING TAXES.  Shall Ordinance No. 339 of the City of Isleton, an ordinance authorizing the City Council to impose an excise tax of not more than $1.00 per day on Short-term commercial parking in the City of Isleton, be approved?",4,4,Sales Tax,100,112,Revenues: Tax Creation/Incr./Contin.,213,122,335,0.6358208955223881,M,1,Pass,0,199600423,213,122,335,0.6358208955223881,1,Pass,1,110
199600425,1996,34,2,SACRAMENTO,1996-11-05,ISLETON,0,M,K,"CITY OF ISLETON TRANSIENT OCCUPANCY TAX.  Shall Ordinance No. 338 of the City of Isleton, an ordinance to increase the transient occupancy tax of the City for hotel guests from seven percent (%) to ten percent (10%) of room rent, be approved.",2,2,Business Tax,100,112,Revenues: Tax Creation/Incr./Contin.,233,107,340,0.6852941176470588,M,1,Pass,0,199600424,233,107,340,0.6852941176470588,1,Pass,1,110
199600426,1996,34,2,SACRAMENTO,1996-11-05,ISLETON,0,M,L,"CITY OF ISLETON CARDROOM TAXES.  Shall Ordinance No. 337 of the City of Isleton, an ordinance to impose business operation taxes upon cardrooms, be approved?",2,2,Business Tax,100,112,Revenues: Tax Creation/Incr./Contin.,271,75,346,0.7832369942196532,M,1,Pass,0,199600425,271,75,346,0.7832369942196532,1,Pass,1,110
199600427,1996,34,2,SACRAMENTO,1996-11-05,ISLETON,0,M,M,CITY OF ISLETON INITIATIVE TAXING CONCEALED WEAPONS LICENSE APPLICATIONS.  Shall an initiative ordinance imposing an general tax of $150 upon each application for a license to carry a concealed weapon and imposing a general tax of $50 for each application for renewal of such a license be approved?,40,40,Initiative,100,112,Revenues: Tax Creation/Incr./Contin.,241,108,349,0.6905444126074498,M,1,Pass,0,199600426,241,108,349,0.6905444126074498,1,Pass,40,110
199600428,1996,34,2,SACRAMENTO,1996-11-05,SACRAMENTO,0,M,O,"To support continued maintenance of trees and parks within the City of Sacramento, shall the existing assessment of $10.89 per year for single family residential properties, $7.41 per unit per year for multi family residential properties, $19.10 per year for 0-25,000 square foot business properties, $95.50 per year for 25,000-100,000 square foot business properties, $198.65 per year for 100,000-or-more square foot business properties, under the Landscaping and Lighting Act, be continued for that same purpose?",3,3,Property Tax,51,51,Environment: Parks/Recreation,74803,29366,104169,0.7180927147231903,T,1,PassT,0,199600427,74803,29366,104169,0.7180927147231903,1,PassT,1,50
199600429,1996,34,2,SACRAMENTO,1996-11-05,SACRAMENTO,0,M,P,"To restore open hours, restore funding for new books, and updated technology in all branch libraries, shall single family residences be assessed $22 per year and all other properties at specified proportional amounts for 10 years, with adjustments not exceeding 3% annually or more than $7 for single family residences during the life of the assessment, and requiring current City library funding either to be maintained or only be reduced proportionally with other non-safety services?",3,3,Property Tax,71,71,Facilities: Libraries,66951,39679,106630,0.6278814592516178,T,2,FailT,0,199600428,66951,39679,106630,0.6278814592516178,2,FailT,1,70
199600430,1996,34,2,SACRAMENTO,1996-11-05,SACRAMENTO,0,M,Q,"Shall the Charter amendment adding Article XVII (Sections 500 through 503) to the Charter of the City of Sacramento providing for mandatory binding arbitration when labor negations between the City and a recognized employee organization ( Union) for police department employees reach impasse, be adopted?",20,20,Charter Amendment,32,32,Safety: Police,56024,43810,99834,0.5611715447643087,M,1,Pass,0,199600429,56024,43810,99834,0.5611715447643087,1,Pass,20,30
199600431,1996,35,2,SAN BENITO,1996-11-05,HOLLISTER,0,M,F,"Shall the two percent (2%) Utility User's Tax imposed by Chapter 19, Article VI, of the Municipal Code be extended for a period of 4 years beginning July 1, 1997?",5,5,Utility Tax,100,112,Revenues: Tax Creation/Incr./Contin.,2281,4624,6905,0.3303403330919624,M,2,Fail,0,199600430,2281,4624,6905,0.33034033309196237,2,Fail,1,110
199600432,1996,36,2,SAN BERNARDINO,1996-11-05,COLTON,0,R,Z,Shall GEORGE V. FULP BE RECALLED (removed) from the office of Mayor (Term Ending November 1998)?,50,50,Recall,48,46,Governance: Recall,4900,4255,9155,0.5352266521026762,M,1,Pass,0,199600431,4900,4255,9155,0.5352266521026762,1,Pass,50,40
199600433,1996,36,2,SAN BERNARDINO,1996-11-05,LOMA LINDA,0,M,A,"Shall the Ordinance of the City of Loma Linda, California, levying a 1.25 percent utility users special tax for police services be approved, and shall the City's appropriations limit be increased by the amount of revenue derived from this tax?",5,5,Utility Tax,32,32,Safety: Police,2355,2393,4748,0.4959983150800337,T,2,FailT,0,199600432,2355,2393,4748,0.4959983150800337,2,FailT,1,30
199600434,1996,36,2,SAN BERNARDINO,1996-11-05,LOMA LINDA,0,M,B,"Shall the Ordinance of the City of Loma Linda, California, levying a .75 percent utility users special tax for street repairs/rehabilitation be approved and shall the City's appropriations limit be increased by the amount of revenue derived from this tax?",5,5,Utility Tax,62,62,Transport: Roads,2212,2491,4703,0.4703380820752711,T,2,FailT,0,199600433,2212,2491,4703,0.4703380820752711,2,FailT,1,60
199600435,1996,36,2,SAN BERNARDINO,1996-11-05,REDLANDS,0,M,C,"Shall Ordinance No. 2328 entitled ""An ordinance of the City of Redlands amending Chapter 3.26 of the Redlands Municipal Code relating to the establishment of an admissions tax"" be approved, and shall a corresponding adjustment in the City's appropriations limit also be adopted?",2,2,Business Tax,200,112,Revenues: Tax Creation/Incr./Contin.,10483,10889,21372,0.49050159086655437,T,2,FailT,0,199600434,10483,10889,21372,0.49050159086655437,2,FailT,1,110
199600436,1996,36,2,SAN BERNARDINO,1996-11-05,REDLANDS,0,M,D,"Shall Ordinance No. 2330 entitled ""An ordinance of the City of Redlands approving assessments levied pursuant to the Landscaping and Lighting Act of 1972"" be adopted?",3,3,Property Tax,100,105,General Services: Maintenance,10689,10439,21128,0.5059163195759182,M,1,Pass,0,199600435,10689,10439,21128,0.5059163195759182,1,Pass,1,100
199600437,1996,36,2,SAN BERNARDINO,1996-11-05,SAN BERNARDINO,0,M,E,"Approves a Charter Amendment which will allow the Mayor power to veto, under the same checks and balances as on the Common Council, any order or resolution of the City of San Bernardino's Community Development Commission.  This veto may be overridden by two-thirds vote of the Redevelopment Commission.",20,20,Charter Amendment,42,42,Governance: Personnel/Labor Relations,18404,14103,32507,0.566154982003876,M,1,Pass,0,199600436,18404,14103,32507,0.566154982003876,1,Pass,20,40
199600438,1996,37,2,SAN DIEGO,1996-11-05,CORONADO,0,M,J,Transient Occupancy Tax of 8%.,2,2,Business Tax,100,112,Revenues: Tax Creation/Incr./Contin.,5765,2286,8051,0.7160601167556826,M,1,Pass,0,199600437,5765,2286,8051,0.7160601167556825,1,Pass,1,110
199600439,1996,37,2,SAN DIEGO,1996-11-05,DEL MAR,0,M,K,Establishes that Regular Municipal Elections would:  1)  Remain in April of even numbered years (576 votes)2)  Change to consolidate with the Statewide Primary election (279 votes)3)  Change to consolidate with the Statewide General election (1605 votes),70,70,Ordinance,48,48,Governance: Elections,1605,576,2181,0.7359009628610729,M,1,Pass,0,199600438,1605,576,2181,0.7359009628610729,1,Pass,70,40
199600440,1996,37,2,SAN DIEGO,1996-11-05,DEL MAR,0,M,L,Advisory Vote Only.  Should the City of Del Mar seek authority to conduct municipal elections by mail ballot?,40,40,Initiative,48,48,Governance: Elections,436,1862,2298,0.18973020017406442,M,2,Fail,0,199600439,436,1862,2298,0.18973020017406442,2,Fail,40,40
199600441,1996,37,2,SAN DIEGO,1996-11-05,EL CAJON,0,M,M,Would repeal an ordinance pertaining to business license tax increases.,2,2,Business Tax,100,111,Revenues: Tax Repeal/Reduction/Limit,10222,12068,22290,0.45859129654553615,M,2,Fail,0,199600440,10222,12068,22290,0.4585912965455361,2,Fail,1,110
199600442,1996,37,2,SAN DIEGO,1996-11-05,ESCONDIDO,0,M,N,Would extend the term of Mayor from two to four years.,70,70,Ordinance,42,42,Governance: Personnel/Labor Relations,16616,14667,31283,0.531151104433718,M,1,Pass,0,199600441,16616,14667,31283,0.531151104433718,1,Pass,70,40
199600443,1996,37,2,SAN DIEGO,1996-11-05,ESCONDIDO,0,M,O,Would amend the Mobilehome Rent Protection Ordinance passed in June 1988.,70,70,Ordinance,82,82,Housing: Rent Control,14093,15368,29461,0.4783612233121754,M,2,Fail,0,199600442,14093,15368,29461,0.4783612233121754,2,Fail,70,80
199600444,1996,37,2,SAN DIEGO,1996-11-05,ESCONDIDO,0,M,P,Would increase the Transient Occupancy Tax to 10%.,2,2,Business Tax,100,112,Revenues: Tax Creation/Incr./Contin.,16569,12671,29240,0.5666552667578659,M,1,Pass,0,199600443,16569,12671,29240,0.5666552667578659,1,Pass,1,110
199600445,1996,37,2,SAN DIEGO,1996-11-05,OCEANSIDE,0,M,R,"Shall the proposed ""Charter of the City of Oceanside"" be adopted?",20,20,Charter Amendment,43,43,Governance: Organization,16026,23365,39391,0.4068442029905308,M,2,Fail,0,199600444,16026,23365,39391,0.4068442029905308,2,Fail,20,40
199600446,1996,37,2,SAN DIEGO,1996-11-05,POWAY,0,M,S,An ordinance to amend the Municipal Code regarding the keeping of horses and other large animals.,70,70,Ordinance,200,200,Other,3495,15214,18709,0.1868084878935272,M,2,Fail,0,199600445,3495,15214,18709,0.1868084878935272,2,Fail,70,200
199600447,1996,37,2,SAN DIEGO,1996-11-05,SAN DIEGO,0,M,C,Charter Amendment.  Would create a branch library Endowment Fund and a Construction Fund with City's proceeds from a Countywide 1/4 cent sales tax.,4,4,Sales Tax,71,71,Facilities: Libraries,178937,157804,336741,0.531378715392542,T,2,FailT,0,199600446,178937,157804,336741,0.531378715392542,2,FailT,1,70
199600448,1996,37,2,SAN DIEGO,1996-11-05,SAN DIEGO,0,M,D,Charter Amendment.  Health insurance benefits for retired city employees to be paid from San Diego City Retirement System.,20,20,Charter Amendment,41,41,Governance: Benefits/Compensation,231410,88537,319947,0.7232760425945547,M,1,Pass,0,199600447,231410,88537,319947,0.7232760425945547,1,Pass,20,40
199600449,1996,37,2,SAN DIEGO,1996-11-05,SAN DIEGO,0,M,E,"Progress Guide and General Plan Amendment.  Phase Shift; change the designation of Seabreeze Farms from ""Future Urbanizing"" to ""Planned Urbanizing.""",70,70,Ordinance,22,22,Land Use: Zoning,180848,131518,312366,0.5789618588450728,M,1,Pass,0,199600448,180848,131518,312366,0.5789618588450728,1,Pass,70,20
199600450,1996,37,2,SAN DIEGO,1996-11-05,SAN DIEGO,0,M,F,"Progress Guide and General Plan Amendment.  Phase Shift; change the designation of specific property (13 acres) within the North City Future Urbanizing Area from ""Future Urbanizing"" to ""Planned Urbanizing.""",70,70,Ordinance,22,22,Land Use: Zoning,97892,220146,318038,0.30779969689156644,M,2,Fail,0,199600449,97892,220146,318038,0.30779969689156644,2,Fail,70,20
199600451,1996,37,2,SAN DIEGO,1996-11-05,SAN DIEGO,0,M,G,"Progress Guide and General Plan Amendment.  Phase Shift; change the designation of specific property (32.8 acres) within the North City Future Urbanizing Area from ""Future Urbanizing"" to ""Planned Urbanizing.""",70,70,Ordinance,22,22,Land Use: Zoning,91424,226101,317525,0.28792693488701676,M,2,Fail,0,199600450,91424,226101,317525,0.28792693488701676,2,Fail,70,20
199600452,1996,37,2,SAN DIEGO,1996-11-05,SAN DIEGO,0,M,H,"Progress Guide and General Plan Amendment.  Phase Shift; change the designation of Torrey Highlands from ""Future Urbanizing"" to ""Planned Urbanizing.""",70,70,Ordinance,22,22,Land Use: Zoning,174388,149609,323997,0.5382395516007864,M,1,Pass,0,199600451,174388,149609,323997,0.5382395516007864,1,Pass,70,20
199600453,1996,37,2,SAN DIEGO,1996-11-05,SAN MARCOS,0,M,T,Would provide for residents review and approval of proposed changes in mobilehome park rules and regulations.,70,70,Ordinance,80,80,Housing,8219,5710,13929,0.590063895469883,M,1,Pass,0,199600452,8219,5710,13929,0.590063895469883,1,Pass,70,80
199600454,1996,39,2,SAN JOAQUIN,1996-11-05,LATHROP,0,M,S,Should the City of Lathrop Impose an Annual Growth Rate Cap of Two Percent (2%) of the Then-Existing Residential Housing?,70,70,Ordinance,21,21,Land Use: Growth Cap/Boundary,724,1419,2143,0.33784414372375177,M,2,Fail,0,199600453,724,1419,2143,0.33784414372375177,2,Fail,70,20
199600455,1996,40,2,SAN LUIS OBISPO,1996-11-05,ATASCADERO,0,M,K,"Shall the adjustments made to the Transient Occupancy Tax (TOT) by Ordinance No. 257 adopted on October 13, 1992 be ratified and approved?",2,2,Business Tax,100,112,Revenues: Tax Creation/Incr./Contin.,6177,3387,9564,0.6458594730238394,M,1,Pass,0,199600454,6177,3387,9564,0.6458594730238394,1,Pass,1,110
199600456,1996,40,2,SAN LUIS OBISPO,1996-11-05,GROVER BEACH,0,R,I,Shall MARCIA HAMILTON be recalled (removed) from the office of Council Member?,50,50,Recall,48,46,Governance: Recall,3147,931,4078,0.7717018146150073,M,1,Pass,0,199600455,3147,931,4078,0.7717018146150073,1,Pass,50,40
199600457,1996,40,2,SAN LUIS OBISPO,1996-11-05,GROVER BEACH,0,M,J,"Shall a measure enacting an ordinance setting a limit of two consecutive terms for elected officials in Grover Beach, be adopted?",70,70,Ordinance,45,45,Governance: Political Reform/Term Limits,3293,743,4036,0.8159068384539149,M,1,Pass,0,199600456,3293,743,4036,0.8159068384539148,1,Pass,70,40
199600458,1996,40,2,SAN LUIS OBISPO,1996-11-05,MORRO BAY,0,M,L,Shall an Ordinance be enacted to create a Community Cablecasting Commission?,70,70,Ordinance,43,43,Governance: Organization,3390,1354,4744,0.7145868465430015,M,1,Pass,0,199600457,3390,1354,4744,0.7145868465430016,1,Pass,70,40
199600459,1996,40,2,SAN LUIS OBISPO,1996-11-05,MORRO BAY,0,M,M,"Shall the Morro Bay Municipal Code be amended to add Chapter 3.22, imposing a transactions and use tax in the amount of one-half of one percent?",4,4,Sales Tax,100,112,Revenues: Tax Creation/Incr./Contin.,3526,1248,4774,0.7385839966485128,M,1,Pass,0,199600458,3526,1248,4774,0.7385839966485128,1,Pass,1,110
199600460,1996,40,2,SAN LUIS OBISPO,1996-11-05,MORRO BAY,0,M,N,"Shall the Ordnance amending Section 3.24.030 of the Morro Bay Municipal Code to increase the Transient Occupancy Tax (""bed tax"") from nine percent (9%) to ten percent (10%) be adopted?",2,2,Business Tax,100,112,Revenues: Tax Creation/Incr./Contin.,3043,1840,4883,0.6231824697931599,M,1,Pass,0,199600459,3043,1840,4883,0.6231824697931599,1,Pass,1,110
199600461,1996,40,2,SAN LUIS OBISPO,1996-11-05,SAN LUIS OBISPO,0,M,O,"ADVISORY VOTE ONLY.  Should the City form a City-wide assessment district for open space protection and park acquisition and development that would raise $1 million annually for this purpose, in accordance with the program guidelines recommended by the Open Space Financing Task Force?",30,30,Advisory,23,23,Land Use: Open Space,8898,8491,17389,0.5117028006210823,M,1,Pass,0,199600460,8898,8491,17389,0.5117028006210823,1,Pass,30,20
199600462,1996,40,2,SAN LUIS OBISPO,1996-11-05,SAN LUIS OBISPO,0,M,P,"Shall City Charter Article IX be amended to add ""Section 909.  Use of Water Supply Reliability Reserve""?",20,20,Charter Amendment,104,104,General Services: Water,9092,4549,13641,0.6665200498497178,M,1,Pass,0,199600461,9092,4549,13641,0.6665200498497178,1,Pass,20,100
199600463,1996,40,2,SAN LUIS OBISPO,1996-11-05,SAN LUIS OBISPO,0,M,Q,Shall City Charter Section 406 be amended to extend the period to time in which to hold an election to fill a Council Vacancy?,20,20,Charter Amendment,48,48,Governance: Elections,9222,4952,14174,0.6506279102582194,M,1,Pass,0,199600462,9222,4952,14174,0.6506279102582193,1,Pass,20,40
199600464,1996,40,2,SAN LUIS OBISPO,1996-11-05,SAN LUIS OBISPO,0,M,R,Shall City Charter Section 109 be amended to delete reference to the City Jail?,20,20,Charter Amendment,31,31,Safety: Jails/Courts,9205,4109,13314,0.6913774973711883,M,1,Pass,0,199600463,9205,4109,13314,0.6913774973711883,1,Pass,20,30
199600465,1996,40,2,SAN LUIS OBISPO,1996-11-05,SAN LUIS OBISPO,0,M,S,Shall City Charter Section 404 (c) extending Councilmember terms of office be deleted?,20,20,Charter Amendment,42,42,Governance: Personnel/Labor Relations,9474,3605,13079,0.7243673063689885,M,1,Pass,0,199600464,9474,3605,13079,0.7243673063689885,1,Pass,20,40
199600466,1996,40,2,SAN LUIS OBISPO,1996-11-05,SAN LUIS OBISPO,0,M,T,Shall City Charter Section 407 concerning the powers and duties of Mayor during an emergency be amended to bring them into conformance with Municipal Code Chapter 2.24?,20,20,Charter Amendment,42,42,Governance: Personnel/Labor Relations,11166,2199,13365,0.8354657687991022,M,1,Pass,0,199600465,11166,2199,13365,0.8354657687991022,1,Pass,20,40
199600467,1996,40,2,SAN LUIS OBISPO,1996-11-05,SAN LUIS OBISPO,0,M,U,Shall City Charter Section 410 concerning the time of payment of Council Compensation be amended to conform with the regular City payroll schedule?,20,20,Charter Amendment,41,41,Governance: Benefits/Compensation,10986,2431,13417,0.8188119549824849,M,1,Pass,0,199600466,10986,2431,13417,0.8188119549824849,1,Pass,20,40
199600468,1996,40,2,SAN LUIS OBISPO,1996-11-05,SAN LUIS OBISPO,0,M,V,Shall City Charter Section 709 be amended to allow the Council to adopt a Personnel Policy by ordinance or resolution?,20,20,Charter Amendment,42,42,Governance: Personnel/Labor Relations,8827,4127,12954,0.6814111471360198,M,1,Pass,0,199600467,8827,4127,12954,0.6814111471360198,1,Pass,20,40
199600469,1996,40,2,SAN LUIS OBISPO,1996-11-05,SAN LUIS OBISPO,0,M,W,Shall City Charter Section 807 concerning property taxes be deleted?,3,3,Property Tax,200,111,Revenues: Tax Repeal/Reduction/Limit,8397,4274,12671,0.6626943414095178,M,1,Pass,0,199600468,8397,4274,12671,0.6626943414095178,1,Pass,1,110
199600470,1996,40,2,SAN LUIS OBISPO,1996-11-05,SAN LUIS OBISPO,0,M,X,Shall City Charter Section 901(A) concerning public works to be done by contract be amended to refer to the Public Contracts Code?,20,20,Charter Amendment,47,47,Governance: Contracting/Bidding/Leasing,10492,2513,13005,0.8067666282199154,M,1,Pass,0,199600469,10492,2513,13005,0.8067666282199154,1,Pass,20,40
199600471,1996,41,2,SAN MATEO,1996-11-05,FOSTER CITY,0,M,X,Shall the ordinance adopted by the City Council stating that no person may hold the office of Councilmember for more than two four-year terms in succession be approved?,70,70,Ordinance,45,45,Governance: Political Reform/Term Limits,7688,3454,11142,0.6900017950098726,M,1,Pass,0,199600470,7688,3454,11142,0.6900017950098726,1,Pass,70,40
199600472,1996,41,2,SAN MATEO,1996-11-05,PACIFICA,0,M,W,Shall the City of Pacifica amend its Municipal Code to prohibit the sale and use of all State-approved fireworks in the City of Pacifica?,70,70,Ordinance,200,206,Other: Fireworks,10744,4582,15326,0.7010309278350515,M,1,Pass,0,199600471,10744,4582,15326,0.7010309278350515,1,Pass,70,200
199600473,1996,42,2,SANTA BARBARA,1996-11-05,GUADALUPE,0,M,L96,"Shall the adjustments made to the Utility Users Tax by Ordinance No. 94-328 adopted by the City Council of the City of Guadalupe, California on March 28, 1994 be ratified and approved, thus retroactively validating all tax previously collected and thus authorizing the continued collection of such tax in the future?",5,5,Utility Tax,200,112,Revenues: Tax Creation/Incr./Contin.,402,682,1084,0.37084870848708484,T,2,FailT,0,199600472,402,682,1084,0.37084870848708484,2,FailT,1,110
199600474,1996,42,2,SANTA BARBARA,1996-11-05,SOLVANG,0,M,N96,Shall an ordinance amending section 3.20.010 and 3.20.020 of Chapter 3.20 of Title 3 of the Solvang Municipal Code to increase the transient occupancy tax be adopted?,2,2,Business Tax,100,112,Revenues: Tax Creation/Incr./Contin.,1251,1074,2325,0.5380645161290323,M,1,Pass,0,199600473,1251,1074,2325,0.5380645161290323,1,Pass,1,110
199600475,1996,43,2,SANTA CLARA,1996-11-05,GILROY,0,M,M,"Shall the City Charter be amended to delete Section 903, an obsolete procedural reference to the election of 1960 that terminated the terms of office of members of boards and commissions in existence at that time?",20,20,Charter Amendment,42,42,Governance: Personnel/Labor Relations,5944,1628,7572,0.7849973586899102,M,1,Pass,0,199600474,5944,1628,7572,0.7849973586899102,1,Pass,20,40
199600476,1996,43,2,SANTA CLARA,1996-11-05,GILROY,0,M,N,Shall Section 611 of the City Charter be amended to allow the City to update the penalties imposed when the City prosecutes misdemeanor violations of its ordinances to the maximum extent allowed by law?,20,20,Charter Amendment,25,25,Land Use: Public Works,5444,2234,7678,0.7090388121906748,M,1,Pass,0,199600475,5444,2234,7678,0.7090388121906747,1,Pass,20,20
199600477,1996,43,2,SANTA CLARA,1996-11-05,GILROY,0,M,O,"Shall Section 904 of the City Charter be amended to authorize the Secretary of any City board or commission, in addition to the City Clerk, to perform certain administrative tasks for that board or commission, and to further allow any City Board or commission to make recommendations by a majority vote of a quorum of the board or commission while continuing to require a majority vote of the entire membership of any City board or commission to take final actions?",20,20,Charter Amendment,43,43,Governance: Organization,5238,2236,7474,0.7008295424137009,M,1,Pass,0,199600476,5238,2236,7474,0.7008295424137009,1,Pass,20,40
199600478,1996,43,2,SANTA CLARA,1996-11-05,GILROY,0,M,P,Shall Section 906 of the City Charter be amended to simplify the obligation of the planning Commission to annually review and recommend to the City Administrator and Council the five year Capital Improvement Budget?,20,20,Charter Amendment,43,43,Governance: Organization,5432,2059,7491,0.7251368308637031,M,1,Pass,0,199600477,5432,2059,7491,0.7251368308637031,1,Pass,20,40
199600479,1996,43,2,SANTA CLARA,1996-11-05,GILROY,0,M,Q,Shall Section 907 of the City Charter be updated and amended to delete obsolete duties of the Personnel Commission while continuing to require the Commission to advise the City on personnel matters and hear appeals of employees in disciplinary actions?,20,20,Charter Amendment,42,42,Governance: Personnel/Labor Relations,5817,1738,7555,0.7699536730641959,M,1,Pass,0,199600478,5817,1738,7555,0.7699536730641959,1,Pass,20,40
199600480,1996,43,2,SANTA CLARA,1996-11-05,MORGAN HILL,0,M,R,"Shall the Morgan Hill Redevelopment Agency continue the community-wide visioning process, fulfill its legal obligations, and do the following:  reduce monthly sewer and water charges; assist in the development of a new public library, a new community center and arts facility, a senior center, and a children and family-oriented recreation facility; improve storm drainage, sewer and water facilities; and foster economic development to help finance police and fire operations.",30,30,Advisory,74,73,Facilities: Museum/Cultural/Comm Ctrs,7352,2434,9786,0.751277334968322,M,1,Pass,0,199600479,7352,2434,9786,0.751277334968322,1,Pass,30,70
199600481,1996,43,2,SANTA CLARA,1996-11-05,MOUNTAIN VIEW,0,M,J,Should Mountain View support air cargo or other commercial or civil aviation at Moffett Federal Airfield?,30,30,Advisory,200,60,Transport,6868,14233,21101,0.32548220463485145,M,2,Fail,0,199600480,6868,14233,21101,0.32548220463485145,2,Fail,30,60
199600482,1996,43,2,SANTA CLARA,1996-11-05,SAN JOSE,0,M,E,"Shall the San Jose City Charter be amended to include the Office of the Independent Police Auditor, which reviews Police Department investigations of complaints against police officers, and to provide that the employment of the Independent Police Auditor and office staff shall be the same as the City Auditor?",20,20,Charter Amendment,32,32,Safety: Police,119594,68945,188539,0.6343196898254473,M,1,Pass,0,199600481,119594,68945,188539,0.6343196898254473,1,Pass,20,30
199600483,1996,43,2,SANTA CLARA,1996-11-05,SAN JOSE,0,M,F,"Shall Sections 901 and 1101 of the City Charter be amended to place persons hired after this election, as assistants to the Mayor and City Council, Assistant Directors of departments, Deputy Directors of departments (excluding the police department), attorneys and supervisors in the Office of the City Attorney and temporary employees employed to fill positions for no more than two years, in the unclassified service of the Civil Service System?",20,20,Charter Amendment,42,42,Governance: Personnel/Labor Relations,93809,83697,177506,0.5284835442182236,M,1,Pass,0,199600482,93809,83697,177506,0.5284835442182236,1,Pass,20,40
199600484,1996,43,2,SANTA CLARA,1996-11-05,SAN JOSE,0,M,G,"Shall ordinance No. 25016, which rezones real property, situated on Senter Road, 500 feet south of Phelan Avenue, from manufacturing to Planned Development to allow an automobile dismantling and recycling center, be approved?",70,70,Ordinance,22,22,Land Use: Zoning,83947,113508,197455,0.42514496973994076,M,2,Fail,0,199600483,83947,113508,197455,0.42514496973994076,2,Fail,70,20
199600485,1996,43,2,SANTA CLARA,1996-11-05,SAN JOSE,0,M,H,"Shall the City of San Jose adopt a Voluntary Campaign Spending Limits ordinance, wherein candidates for Mayoral and City Councilmember elections who do not volunteer for spending caps will be subject to greater limitations on accepting individual donations than those that do?  In setting the contribution limits, the Council will consider recommendations of the Campaign Finance Review and Ethics Board, which is made up of private citizens.",30,30,Advisory,45,45,Governance: Political Reform/Term Limits,135043,51868,186911,0.7224989433473685,M,1,Pass,0,199600484,135043,51868,186911,0.7224989433473685,1,Pass,30,40
199600486,1996,43,2,SANTA CLARA,1996-11-05,SAN JOSE,0,M,I,"Without imposing additional taxes or taking money from other city programs, shall Ordinance No. 14224.1 be amended to permit the relocation and consolidation of civic offices in the downtown so long as the costs are paid by using the proceeds from the sale or lease of the old civic complex and other land, savings from the elimination of leased office space, and consolidation of city facilities and services?",70,70,Ordinance,70,70,Facilities,120176,76624,196800,0.610650406504065,M,1,Pass,0,199600485,120176,76624,196800,0.610650406504065,1,Pass,70,70
199600487,1996,43,2,SANTA CLARA,1996-11-05,SARATOGA,0,M,K,"Shall the General Plan of the City of Saratoga be amended by allowing an approximately 1/2 acre portion of a 8.4 acre parcel located at 13570 Pierce Road to be redesignated from land use designation ""Hillside Conservation Single Family to ""Very Low Density Single Family,"" thereby allowing said 1/2 acre parcel to be combined with an adjacent existing 1/2 acre parcel to form an approximately 1 acre parcel?",70,70,Ordinance,22,22,Land Use: Zoning,10959,2536,13495,0.812078547610226,M,1,Pass,0,199600486,10959,2536,13495,0.812078547610226,1,Pass,70,20
199600488,1996,43,2,SANTA CLARA,1996-11-05,SARATOGA,0,M,L,"Shall the existing City of Saratoga Utility Users Tax be extended, with no increase in the tax rate, to January 1, 2001, unless extended beyond that date by a further vote of the people?",5,5,Utility Tax,100,112,Revenues: Tax Creation/Incr./Contin.,6687,6764,13451,0.4971377592744034,M,2,Fail,0,199600487,6687,6764,13451,0.4971377592744034,2,Fail,1,110
199600489,1996,45,2,SHASTA,1996-11-05,SHASTA LAKE,0,M,B,Shall the City of Shasta Lake adopt a Special Tax to be used exclusively for Police Protection Services and to be levied on each parcel of property within the City and limited to the amount set forth in the Ordinance?  The Special Tax will be terminate in five years.  The City's appropriation limit will be increased by the amount of SPECIAL TAX FOR POLICE PROTECTION SERVICES.,60,60,Gann Limit,32,32,Safety: Police,677,2214,2891,0.23417502594258044,T,2,FailT,0,199600488,677,2214,2891,0.2341750259425804,2,FailT,60,30
199600490,1996,47,2,SISKIYOU,1996-11-05,DUNSMUIR,0,M,A,"Shall proposed Ordinance No. 53 be adopted by the voters of the City of Dunsmuir in order to approve and reaffirm the basic provisions of the fire equipment benefit assessment which was previously adopted by the City Council, as Ordinance No. 500, with the funds to be used only for Dunsmuir Fire Department vehicles and equipment?",70,70,Ordinance,33,33,Safety: Fire,612,148,760,0.8052631578947369,M,1,Pass,0,199600489,612,148,760,0.8052631578947368,1,Pass,70,30
199600491,1996,47,2,SISKIYOU,1996-11-05,MT. SHASTA,0,M,B,"Shall Ordinance 96-04, which amends the city sign ordinance to allow the continuation of a pre-existing non-conforming brand-name sign on a service station, be adopted?",70,70,Ordinance,200,200,Other,753,716,1469,0.5125936010891763,M,1,Pass,0,199600490,753,716,1469,0.5125936010891763,1,Pass,70,200
199600492,1996,48,2,SOLANO,1996-11-05,DIXON,0,M,B,Shall an Ordinance be adopted that would continue to limit growth to a number of new dwelling units equal to 3% or less of the total number of housing units existing on December 31st of each calendar year and to achieve and approximate mix f 80% single family housing to 20% multiple housing units?  This ordinance would not apply to four or fewer units per existing lots in the Central Dixon Redevelopment Area.,70,70,Ordinance,21,21,Land Use: Growth Cap/Boundary,3005,1307,4312,0.6968923933209648,M,1,Pass,0,199600491,3005,1307,4312,0.6968923933209648,1,Pass,70,20
199600493,1996,48,2,SOLANO,1996-11-05,SUISUN,0,M,F,Should Measure E be repealed and Suisun City's Card Club Ordinance No. 626 be amended to prohibit a card club?,70,70,Ordinance,200,200,Other,3422,3400,6822,0.5016124303723248,M,1,Pass,0,199600492,3422,3400,6822,0.5016124303723248,1,Pass,70,200
199600494,1996,49,2,SONOMA,1996-11-05,HEALDSBURG,0,M,I,Shall the ordinance amending the General Plan to establish urban growth boundaries in the City of Healdsburg be adopted?,70,70,Ordinance,21,21,Land Use: Growth Cap/Boundary,2923,1205,4128,0.7080910852713178,M,1,Pass,0,199600493,2923,1205,4128,0.7080910852713178,1,Pass,70,20
199600495,1996,49,2,SONOMA,1996-11-05,PETALUMA,0,M,J,"Shall the voters of the City of Petaluma amend Charter ""Section 19-Salaries"" to read ""The Council may act, by ordinance, to provide compensation to each of its members in an amount authorized by state law.  The Council may act, by ordinance, to provide compensation to the Mayor in an amount up to 150 percent of the compensation set for Council members.""? (which currently would allow up to $400 a month for Council members).",20,20,Charter Amendment,41,41,Governance: Benefits/Compensation,8603,10137,18740,0.45907150480256137,M,2,Fail,0,199600494,8603,10137,18740,0.45907150480256137,2,Fail,20,40
199600496,1996,49,2,SONOMA,1996-11-05,PETALUMA,0,M,K,"Shall the voters of the City of Petaluma amend Charter ""Section 23 - The City Manager"" to delete the sentence, ""He shall be appointed for an indefinite period.""?",20,20,Charter Amendment,42,42,Governance: Personnel/Labor Relations,14054,4781,18835,0.7461640562782055,M,1,Pass,0,199600495,14054,4781,18835,0.7461640562782055,1,Pass,20,40
199600497,1996,49,2,SONOMA,1996-11-05,PETALUMA,0,M,L,"Shall the voters of the City of Petaluma amend Charter ""Section 23 - The City Manager"" to delete ""He cannot be removed from office except by a vote of five members of the council,"" and replace that with ""He cannot be removed from office except by a vote of four members of the council.""?",20,20,Charter Amendment,42,42,Governance: Personnel/Labor Relations,12171,5571,17742,0.6859993236388232,M,1,Pass,0,199600496,12171,5571,17742,0.6859993236388231,1,Pass,20,40
199600498,1996,49,2,SONOMA,1996-11-05,ROHNERT PARK,0,M,M,"Shall the City Council of the City of Rohnert Park establish a Fire Suppression Benefit Assessment under the Fire Suppression Assessment Law (California Government Code Section 50078 et seq.) for the purposes specified in the Act with a proposed total assessment of $361,000 per year which may be adjusted each following year according to the change in the consumer price index, not to exceed three percent (3%)?",3,3,Property Tax,33,33,Safety: Fire,7242,5581,12823,0.5647664353115496,T,2,FailT,0,199600497,7242,5581,12823,0.5647664353115496,2,FailT,1,30
199600499,1996,49,2,SONOMA,1996-11-05,ROHNERT PARK,0,M,N,"Shall the City Council of the City of Rohnert Park amend the General Plan of the City of Rohnert Park and add an Urban Boundary Policy and set the Urban Boundary contiguous with the existing City Limits with the addition of only 23.9 acres located north and south of Wilfred Avenue and west of Redwood Drive, and the Creekside Middle School site until July 1, 2000?",70,70,Ordinance,21,21,Land Use: Growth Cap/Boundary,6792,6435,13227,0.5134951236107961,M,1,Pass,0,199600498,6792,6435,13227,0.5134951236107961,1,Pass,70,20
199600500,1996,49,2,SONOMA,1996-11-05,SANTA ROSA,0,M,G,Shall the voters of the City of Santa Rosa adopt an ordinance amending Section 17-28.010 of the Santa Rosa City Code to restrict changes to the City's urban boundary to twenty-year intervals?,70,70,Ordinance,21,21,Land Use: Growth Cap/Boundary,28080,20138,48218,0.5823551370857356,M,1,Pass,0,199600499,28080,20138,48218,0.5823551370857356,1,Pass,70,20
199600501,1996,49,2,SONOMA,1996-11-05,SANTA ROSA,0,M,H,"Without increasing local taxes, shall the City of Santa Rosa be authorized to approve the development, construction or acquisition of units as affordable rental housing for low income persons, including the elderly and disabled?  Such housing shall only be owned by private developers who receive federal, state or local assistance and shall be authorized annually in an amount not to exceed one half of one percent of the existing housing units in Santa Rosa.",70,70,Ordinance,81,81,Housing: Affordable,32458,14633,47091,0.6892612176424371,M,1,Pass,0,199600500,32458,14633,47091,0.689261217642437,1,Pass,70,80
199600502,1996,49,2,SONOMA,1996-11-05,SEBASTOPOL,0,M,O,"Shall the ordinance known as the ""Sebastopol Urban Growth Boundary Initiative"" be approved?",40,40,Initiative,21,21,Land Use: Growth Cap/Boundary,2226,1124,3350,0.6644776119402985,M,1,Pass,0,199600501,2226,1124,3350,0.6644776119402985,1,Pass,40,20
199600503,1996,49,2,SONOMA,1996-11-05,SONOMA,0,M,P,"Shall the office of City Clerk be appointive beginning November 7, 2000, or upon any vacancy in that office prior to the end of that tern?",70,70,Ordinance,42,42,Governance: Personnel/Labor Relations,2650,1440,4090,0.6479217603911981,M,1,Pass,0,199600502,2650,1440,4090,0.6479217603911981,1,Pass,70,40
199600504,1996,49,2,SONOMA,1996-11-05,WINDSOR,0,M,Q,"Shall (1) a resolution to amend the ""Windsor General Plan - 2015"" to change the land-use designation for the Shiloh Property (located at the northeast quadrant of U.S. 101 and Shiloh Road) from Light Industrial to Gateway Commercial and (2) an ordinance to rezone the Shiloh Property from M-1, Light Industrial to PC, Planned Community and to approve a preliminary development plan for development of a retail commercial center on the Shiloh Property be adopted?",70,70,Ordinance,22,22,Land Use: Zoning,4255,4172,8427,0.5049246469680788,M,1,Pass,0,199600503,4255,4172,8427,0.5049246469680788,1,Pass,70,20
199600505,1996,49,2,SONOMA,1996-11-05,WINDSOR,0,M,R,"Shall the Town Council's motion regarding garbage collection and recycling services which would reduce residential customer rates, reduce franchise fees, limit cost-of-living increases and extend the contract with Empire Waste Management be approved?",70,70,Ordinance,47,47,Governance: Contracting/Bidding/Leasing,4092,4141,8233,0.4970241710190696,M,2,Fail,0,199600504,4092,4141,8233,0.4970241710190696,2,Fail,70,40
199600506,1996,49,2,SONOMA,1996-11-05,WINDSOR,0,M,S,"Shall an ordinance be adopted by the Town of Windsor which requires Town refuse, recycling and compost collection agreements be subject to competitive bidding?",70,70,Ordinance,47,47,Governance: Contracting/Bidding/Leasing,6505,1489,7994,0.8137353014761071,M,1,Pass,0,199600505,6505,1489,7994,0.8137353014761071,1,Pass,70,40
199600507,1996,50,2,STANISLAUS,1996-11-05,WATERFORD,0,M,L,Shall the office of city treasurer be appointed?,70,70,Ordinance,42,42,Governance: Personnel/Labor Relations,602,897,1499,0.4016010673782522,M,2,Fail,0,199600506,602,897,1499,0.4016010673782522,2,Fail,70,40
199600508,1996,50,2,STANISLAUS,1996-11-05,WATERFORD,0,M,M,Shall the office of city clerk be appointed?,70,70,Ordinance,42,42,Governance: Personnel/Labor Relations,608,902,1510,0.40264900662251657,M,2,Fail,0,199600507,608,902,1510,0.40264900662251657,2,Fail,70,40
199600509,1996,51,2,SUTTER,1996-11-05,LIVE OAK,0,M,AA,Shall the offices of City Clerk and City Treasurer be appointive?,70,70,Ordinance,42,42,Governance: Personnel/Labor Relations,559,514,1073,0.5209692451071761,M,1,Pass,0,199600508,559,514,1073,0.5209692451071761,1,Pass,70,40
199600510,1996,51,2,SUTTER,1996-11-05,YUBA CITY,0,M,CC,Increase transient occupancy tax from 6% to 10%.,2,2,Business Tax,100,112,Revenues: Tax Creation/Incr./Contin.,4145,5231,9376,0.4420861774744027,M,2,Fail,0,199600509,4145,5231,9376,0.4420861774744027,2,Fail,1,110
199600511,1996,52,2,TEHAMA,1996-11-05,CORNING,0,M,F,"ADVISORY VOTE ONLY.  Are you in favor of the formation of a Parks and Recreation Service District, which would require an annual household tax?",30,30,Advisory,51,51,Environment: Parks/Recreation,1066,3191,4257,0.25041108762038994,M,2,Fail,0,199600510,1066,3191,4257,0.25041108762038994,2,Fail,30,50
199600512,1996,52,2,TEHAMA,1996-11-05,RED BLUFF,0,M,E,Shall the office of City Clerk be appointive by the City Council?,70,70,Ordinance,42,42,Governance: Personnel/Labor Relations,1389,2602,3991,0.34803307441743925,M,2,Fail,0,199600511,1389,2602,3991,0.34803307441743925,2,Fail,70,40
199600513,1996,54,2,TULARE,1996-11-05,TULARE,0,M,Q,"Shall an amendment to the Freeholders Charter of the City of Tulare, amending Section 14 thereof, revising the date at which newly elected council members are sworn in and assume office and at which the mayor is chosen, be adopted?",20,20,Charter Amendment,42,42,Governance: Personnel/Labor Relations,4951,2690,7641,0.6479518387645596,M,1,Pass,0,199600512,4951,2690,7641,0.6479518387645596,1,Pass,20,40
199600514,1996,54,2,TULARE,1996-11-05,TULARE,0,M,R,"Shall an amendment to the Freeholders Charter of the City of Tulare, deleting Sections 60 through 66 inclusive, providing for the removal from the Charter of all references to the Board of Education and the Superintendent of Schools of the Tulare City School District, be adopted?",20,20,Charter Amendment,12,12,Education: Districts,4220,3244,7464,0.5653804930332261,M,1,Pass,0,199600513,4220,3244,7464,0.5653804930332261,1,Pass,20,10
199600515,1996,54,2,TULARE,1996-11-05,TULARE,0,M,S,"Shall an amendment to the Freeholders Charter of the City of Tulare, amending Section 13 thereof, providing that council members shall receive compensation equivalent to fifty percent (50%) of the maximum amount which can be paid to council members of general law cities whose population is similar to that of the City of Tulare, be adopted?",20,20,Charter Amendment,41,41,Governance: Benefits/Compensation,3088,4570,7658,0.40323844345782195,M,2,Fail,0,199600514,3088,4570,7658,0.4032384434578219,2,Fail,20,40
199600516,1996,54,2,TULARE,1996-11-05,TULARE,0,M,T,"Shall an amendment to the Freeholders Charter of the City of Tulare requiring advertising one time in the local paper for bids for contracts for public buildings and public works projects, be adopted?",20,20,Charter Amendment,47,47,Governance: Contracting/Bidding/Leasing,5207,2488,7695,0.6766731643924626,M,1,Pass,0,199600515,5207,2488,7695,0.6766731643924626,1,Pass,20,40
199600517,1996,56,2,VENTURA,1996-11-05,FILLMORE,0,M,G,Shall the office of city clerk be appointive?,70,70,Ordinance,42,42,Governance: Personnel/Labor Relations,1426,1779,3205,0.4449297971918877,M,2,Fail,0,199600516,1426,1779,3205,0.4449297971918877,2,Fail,70,40
199600518,1996,56,2,VENTURA,1996-11-05,FILLMORE,0,M,H,Shall the office of city treasurer be appointive?,70,70,Ordinance,42,42,Governance: Personnel/Labor Relations,1351,1838,3189,0.4236437754782063,M,2,Fail,0,199600517,1351,1838,3189,0.4236437754782063,2,Fail,70,40
199600519,1996,56,2,VENTURA,1996-11-05,OXNARD,0,M,Z,"Shall the ordinance adopted by the Oxnard City Council establishing a utility users' tax, which proceeds are to be used exclusively for police and fire services, at 3.5 percent of the charges for telephone, electricity, gas, water, solid waste collection, wastewater collection/treatment, and cable television/satellite systems, to be collected as part of utility bills, with a maximum tax payable of $120.00 per residence service and $4,000 per commercial/industrial service, be approved?",5,5,Utility Tax,34,34,Safety: Multiple Emergency Services,13356,18909,32265,0.41394700139470014,T,2,FailT,0,199600518,13356,18909,32265,0.41394700139470014,2,FailT,1,30
199600520,1996,56,2,VENTURA,1996-11-05,PORT HUENEME,0,M,A,Shall the Charter proposed for the City of Port Hueneme be adopted?,20,20,Charter Amendment,43,43,Governance: Organization,3099,1711,4810,0.6442827442827442,M,1,Pass,0,199600519,3099,1711,4810,0.6442827442827442,1,Pass,20,40
199600521,1996,56,2,VENTURA,1996-11-05,PORT HUENEME,0,M,B,"Shall Ordinance No. 608 entitled ""AN ORDINANCE OF THE PEOPLE OF THE CITY OF PORT HUENEME, CALIFORNIA, APPROVING FROM THE EFFECTIVE DATE OF THE ELECTION FORWARD, A UTILITY USERS TAX AT THE SAME RATE AS IS CURRENTLY SET FORTH IN THE PORT HUENEME MUNICIPAL CODE,"" be approved?",5,5,Utility Tax,100,112,Revenues: Tax Creation/Incr./Contin.,2982,1814,4796,0.621768140116764,M,1,Pass,0,199600520,2982,1814,4796,0.621768140116764,1,Pass,1,110
199600522,1996,56,2,VENTURA,1996-11-05,PORT HUENEME,0,M,C,"Shall Ordinance No. 609, entitled ""AN ORDINANCE OF THE PEOPLE OF THE CITY OF PORT HUENEME, VALIDATING AN ORDINANCE ADOPTED BY THE CITY COUNCIL RELATING TO UTILITY USERS TAX FROM NOVEMBER 2, 1994 THROUGH, AND INCLUDING THE EFFECTIVE DATE OF ELECTION,"" be approved?",5,5,Utility Tax,100,112,Revenues: Tax Creation/Incr./Contin.,2844,2005,4849,0.5865126830274283,M,1,Pass,0,199600521,2844,2005,4849,0.5865126830274283,1,Pass,1,110
199600523,1996,56,2,VENTURA,1996-11-05,SANTA PAULA,0,M,F,Shall the offices of City Clerk and City Treasurer be appointive?  Yes or No?,70,70,Ordinance,42,42,Governance: Personnel/Labor Relations,2850,3553,6403,0.44510385756676557,M,2,Fail,0,199600522,2850,3553,6403,0.44510385756676557,2,Fail,70,40
199600524,1996,56,2,VENTURA,1996-11-05,THOUSAND OAKS,0,M,D,"Shall the Ordinance e adopted, which will increase the City's current tax on the construction of new residential dwelling units for open space and park purposes from $100 to $400 per new mobilehome space or one-bedroom dwelling unit, from $150 to $600 per new two-bedroom unit, and from $200 to $800 pr new three or more bedroom dwelling unit?",3,3,Property Tax,23,23,Land Use: Open Space,24941,18241,43182,0.5775786207215969,T,2,FailT,0,199600523,24941,18241,43182,0.5775786207215969,2,FailT,1,20
199600525,1996,56,2,VENTURA,1996-11-05,THOUSAND OAKS,0,M,E,"Shall the ordinance be adopted, requiring vote approval of any change of the City's Land Use Element of the General Plan, which change increases the net allowable residential density or total commercial acreage in the General Plan?",70,70,Ordinance,21,21,Land Use: Growth Cap/Boundary,32420,11012,43432,0.746454227297845,M,1,Pass,0,199600524,32420,11012,43432,0.7464542272978449,1,Pass,70,20
199600526,1996,57,2,YOLO,1996-11-05,WOODLAND,0,M,B,"Shall Resolution No. 3944, approved by the Woodland City Council on February 27, 1996, entitled ""Resolution of the City Council of the City of Woodland Certifying The Environmental impact Report for the General Plan, Making Findings, and Adopting the General Plan for the City of Woodland,"" be adopted?",70,70,Ordinance,20,20,Land Use,9211,5144,14355,0.6416579588993382,T,2,FailT,0,199600525,9211,5144,14355,0.6416579588993382,2,FailT,70,20
199600527,1996,58,2,YUBA,1996-11-05,WHEATLAND,0,M,L,"Shall City of Wheatland, Ordinance No. 362, which would levy a general utility users' tax on city water and sewer system users at the rate of 35 percent of the city water and sewer charges, be adopted?",5,5,Utility Tax,104,104,General Services: Water,306,423,729,0.41975308641975306,M,2,Fail,0,199600526,306,423,729,0.41975308641975306,2,Fail,1,100
199600528,1996,1,3,ALAMEDA,1996-11-05,OAKLAND UNIFIED SCHOOL DISTRICT,0,M,B,"To improve the learning of basic skills necessary to our children=s future, shall the Oakland Unified School District levy a special tax to: . reduce class size; . provide after school learning to keep youth away from gangs and drugs; . improve high school career programs to better prepare students for the job market; . purchase books and other teaching supplies; . improve science and technology programs for only five years at $75 per parcel exempting low-income property owners?",3,3,Property Tax,10,10,Education,86272,20541,106813,0.8076919476093734,T,1,PassT,0,199600527,86272,20541,106813,0.8076919476093734,1,PassT,1,10
199600529,1996,1,3,ALAMEDA,1996-11-05,PERALTA COMMUNITY COLLEGE DISTRICT,0,M,A,"To provide Peralta Community College District students with improved educational and training opportunities and to acquire and construct educational facilities for Vista College, shall the Peralta Community College District use previously authorized Measure B Bonds and issue $8 million in additional bonds with an interest rate not to exceed the legal limit?",11,11,GO Bond,11,11,Education: Bonds,136146,38738,174884,0.7784931726172777,T,1,PassT,0,199600528,136146,38738,174884,0.7784931726172777,1,PassT,10,10
199600530,1996,3,3,AMADOR,1996-11-05,AMADOR COUNY UNIFIED SCHOOL DISTRICT,0,M,S,Shall Amador County Unified School District be divided into seven trustee areas of equal population having one trustee from each area enacted for the General Election in November 1988?,70,70,Ordinance,12,12,Education: Districts,6449,6136,12585,0.5124354390147,M,1,Pass,0,199600529,6449,6136,12585,0.5124354390147,1,Pass,70,10
199600531,1996,7,3,CONTRA COSTA,1996-11-05,CONTRA COSTA COMMUNITY COLLEGE DISTRICT,0,M,D,"To meet the rapidly expanding educational, job preparation and retraining needs of Contra Costa County, shall Contra Costa Community College District be authorized to issue its first bonds since its establishment in 1948 in the principal amount of $145,000,000 at interest rates within the statutory maximum to finance educational technology, construction, renovation improvement and acquisition of facilities, including improvements for physical access and safety at Diablo Valley College, Los Medanos College, and Contra Costa College and the Center for Higher Education?",11,11,GO Bond,11,11,Education: Bonds,211299,112302,323601,0.6529615174242354,T,2,FailT,0,199600530,211299,112302,323601,0.6529615174242354,2,FailT,10,10
199600532,1996,7,3,CONTRA COSTA,1996-11-05,WEST CONTRA COSTA UNIFIED SCHOOL DISTRICT,0,M,E,"To improve, maintain and make safe its public recreational facilities, thereby freeing up District resources for retention of additional teachers and continuing a sixth period at middle schools, shall the West Contra Costa Unified School District continue to levy in its Maintenance and Recreational Assessment District an annual assessment per parcel not to exceed the existing rate of $72.00 per single family equivalent unit, as described in the engineer's report on file with the District?",3,3,Property Tax,10,10,Education,44078,20931,65009,0.6780291959574828,T,1,PassT,0,199600531,44078,20931,65009,0.6780291959574828,1,PassT,1,10
199600533,1996,10,3,FRESNO,1996-11-05,CARUTHERS UNION HIGH SCHOOL DISTRICT,0,M,A,"Shall the territory of the Caruthers Union High School District e unified without affecting the Alvina, Monroe, and Raisin City School Districts an be governed by a seven member Board of Trustees elected by the voters of the District at-large; each trustee shall reside in a specific trustee area?",70,70,Ordinance,12,12,Education: Districts,969,607,1576,0.6148477157360406,M,1,Pass,0,199600532,969,607,1576,0.6148477157360406,1,Pass,70,10
199600534,1996,16,3,KINGS,1996-11-05,LEMOORE UNION ELEMENTARY,0,M,L,"Shall the Lemoore Union Elementary School District incur a bonded indebtedness of $3,100,000 with an interest rate not to exceed the statutory limit for the purpose of constructing school facilities including the completion of the facilities master plan at the Liberty Middle School by the addition of a classroom win and gymnasium",11,11,GO Bond,11,11,Education: Bonds,2808,1805,4613,0.6087145024929547,T,2,FailT,0,199600533,2808,1805,4613,0.6087145024929547,2,FailT,10,10
199600535,1996,19,3,LOS ANGELES,1996-11-05,BASSETT UNIFIED SCHOOL DISTRICT,0,M,R,"Shall the Merit System for school employees not requiring certification qualifications, as provided for in Article 6, commencing with Section 45240, of Chapter of Part 25, of Division 3 of Title 2 of the Education Code of the State of California, and which has been in operation for at least five years, be terminated by the Bassett Unified School District of Los Angeles County on December 15, 1996.",70,70,Ordinance,12,12,Education: Districts,1668,2926,4594,0.3630822812363953,M,2,Fail,0,199600534,1668,2926,4594,0.3630822812363953,2,Fail,70,10
199600536,1996,19,3,LOS ANGELES,1996-11-05,CULVER CITY UNIFIED SCHOOL DISTRICT,0,M,T,"To provide needed fire, health and safety improvements such as: earthquake retrofitting, fire alarms, roof repairs, asbestos removal, sewage and drainage repairs and increased lighting; to integrate computer technology; to upgrade deteriorating school classrooms and grounds; to construct and acquire school sites and facilities; and to provide for long term capital improvements districtwide, shall the Culver City Unified School District be authorized to issue up to $40,000,000 in bonds to bear interest rates not exceeding the statutory maximum?",11,11,GO Bond,11,11,Education: Bonds,12441,3112,15553,0.7999099852118562,T,1,PassT,0,199600535,12441,3112,15553,0.7999099852118562,1,PassT,10,10
199600537,1996,19,3,LOS ANGELES,1996-11-05,HACIENDA LA PUENTE UNIFIED SCHOOL DISTRICT,0,M,W,"Shall the merit (civil service) system for school employees not requiring certification qualifications, as provided for in Article 6 (commencing with Section 45240) of Chapter 5 of Part 25, of Division 3 of Title 2 of the Education Code of the State of California, and which has been in operation for at least five years, be terminated by the Hacienda La Puente Unified School District of Los Angeles County on December 1st, 1996?",70,70,Ordinance,12,12,Education: Districts,10054,15644,25698,0.3912366721145615,M,2,Fail,0,199600536,10054,15644,25698,0.3912366721145614,2,Fail,70,10
199600538,1996,19,3,LOS ANGELES,1996-11-05,LOS ANGELES COMMUNITY COLLEGE DISTRICT,0,M,AA,"The Los Angeles Community College District agrees to be bound by this vote:  Shall the District levy its Landscaping and Lighting assessment of up to $12 annually per single-family parcel (more for other parcels) for purposes including adding/improving lighting on campuses to decrease crime; reconstructing deteriorating roads, walkways, wall/fences to make campuses secure; repairing unsafe physical education facilities used by students and the public; improving landscaping drainage to prevent flooding; and constructing related facilities?",30,30,Advisory,100,105,General Services: Maintenance,498720,531088,1029808,0.4842844491400339,M,2,Fail,0,199600537,498720,531088,1029808,0.4842844491400339,2,Fail,30,100
199600539,1996,19,3,LOS ANGELES,1996-11-05,LOS ANGELES UNIFIED SCHOOL DISTRICT,0,M,BB,"Shall the Los Angeles Unified School District incur a bonded indebtedness of $2,400,000,000 with an interest rate not to exceed that allowed by law, for the following purposes:  Health and safety repairs and improvements to 15,000 classrooms in more than 800 deteriorating school buildings, including upgraded electrical wiring, plumbing, campus security and air conditioning; earthquake retrofitting; asbestos removal; computer technology; new and factory built classrooms to reduce class sizes; with no money for administrators' salaries?",11,11,GO Bond,11,11,Education: Bonds,588077,309595,897672,0.655113449010329,T,2,FailT,0,199600538,588077,309595,897672,0.655113449010329,2,FailT,10,10
199600540,1996,19,3,LOS ANGELES,1996-11-05,PARAMOUNT UNIFIED SCHOOL DISTRICT,0,M,S,"Shall the Paramount Unified School District incur bonded indebtedness in an amount not to exceed $23,100,000 with an interest rate not to exceed the maximum rate allowed by law in order to build new schools, repair and rehabilitate schools built over 30 years ago including the repair and replacement of existing plumbing, wiring, and security systems, and to provide for computers, science, and technology laboratories at schools throughout the District so long as no bond monies are used for administrative salaries?",11,11,GO Bond,11,11,Education: Bonds,7542,4228,11770,0.6407816482582839,T,2,FailT,0,199600539,7542,4228,11770,0.6407816482582838,2,FailT,10,10
199600541,1996,19,3,LOS ANGELES,1996-11-05,WHITTIER SCHOOLS COMMUNITY FACILITIES DISTRICT,0,M,GG,"In order to repair aging schools and reduce overcrowding in the Whittier City School District, shall the Whittier Schools Community Facilities District finance the following projects through a levy on property as identified in Resolution No. 9697-R-2: repair and rehabilitate existing classrooms, replace outdated heating and cooling systems, rewire classrooms for modern technology and acquire and construct new classrooms and facilities, so long as: i) the levy, as initially set, does not increase the total amount of levies and assessments currently collected in the District and II) senior citizens may request an exemption from the levy?",3,3,Property Tax,10,10,Education,11642,5731,17373,0.6701203016174525,T,1,PassT,0,199600540,11642,5731,17373,0.6701203016174524,1,PassT,1,10
199600542,1996,21,3,MARIN,1996-11-05,LARKSPUR ELEMENTARY SCHOOL DISTRICT,0,M,C,"Shall the Larkspur School District approve the Tiscornia Estate Company's request to transfer the uninhabited territory known as the King Mountain Estates, together with the associate property taxes and other revenues, from the Larkspur School District to the Kentfield School District?",70,70,Ordinance,12,12,Education: Districts,1106,5177,6283,0.17603055865032627,M,2,Fail,0,199600541,1106,5177,6283,0.17603055865032627,2,Fail,70,10
199600543,1996,21,3,MARIN,1996-11-05,SHORELINE JOINT UNIFIED SCHOOL DISTRICT,0,M,B,"Shall the Shoreline Unified School District provide funds to maintain and expand specific educational programs by levying a qualified special tax assessment of one hundred twenty dollars per year per assessor's parcel for a limited period of four (4) years, beginning July 1. 1997?",3,3,Property Tax,12,12,Education: Districts,1586,601,2187,0.7251943301326017,T,1,PassT,1,199600562,2358,1062,3420,0.6894736842105263,1,PassT,1,10
199600544,1996,23,3,MENDOCINO,1996-11-05,MENDOCINO UNIFIED SCHOOL DISTRICT,0,M,D,"Shall the Mendocino Unified School District's current annual assessment of $30.00 per year per improved parcel under its maintenance assessment district be confirmed, and shall the Mendocino Unified School District be authorized to continue to levy annual assessments pursuant to the procedure set forth in the Landscaping and Lighting Act of 1972, Commencing with Streets and Highways Code Section 22500 et seq.?",3,3,Property Tax,11,11,Education: Bonds,1976,1069,3045,0.6489326765188834,T,2,FailT,0,199600542,1976,1069,3045,0.6489326765188834,2,FailT,1,10
199600545,1996,27,3,MONTEREY,1996-11-05,PASO ROBLES JOINT UNIFIED SCHOOL DISTRICT-PROPOSED,0,M,F,"Shall the Paso Robles Joint Union High School District and the Paso Robles Union Elementary School District be unified to form the Paso Robles Joint Unified School District, while preserving the San Miguel Joint Union School District and Pleasant Valley Joint Union Elementary School District as separate elementary school districts?",70,70,Ordinance,12,12,Education: Districts,27,15,42,0.6428571428571429,M,1,Pass,1,199600550,9684,2113,11797,0.8208866661015513,1,Pass,70,10
199600546,1996,27,3,MONTEREY,1996-11-05,SAN LUIS OBISPO COMMUNITY COLLEGE DISTRICT,0,M,G,Shall trustee areas and the election of one member of the governing board of the San Luis Obispo County Community College District residing in each Trustee area elected by the registered voters of the entire San Luis Obispo County Community College District be established?,70,70,Ordinance,12,12,Education: Districts,92,50,142,0.6478873239436621,M,1,Pass,1,199600551,46550,31640,78190,0.5953446732318711,1,Pass,70,10
199600547,1996,33,3,RIVERSIDE,1996-11-05,HEMET UNIFIED SCHOOL DISTRICT,0,M,Q,"Shall the Idylwild Community Facilities District (the ""Idylwild CFD"") of the Hemet Unified School District be authorized to finance the cost of school facilities, primarily a gymnasium/theater complex and a covered lunch area by incurring bonded indebtedness in a maximum amount of $3,500000, and shall the Idylwild CFD be authorized to annually levy special taxes on property as set forth in Resolution No. 791 of the Hemet Unified School District to pay for such facilities and to pay for such bonded indebtedness and shall an appropriations limit be established for the Idlylwild CFD as described in Resolution No. 791?",13,13,Mello/Roos Bond,11,11,Education: Bonds,838,1070,1908,0.43920335429769397,T,2,FailT,0,199600543,838,1070,1908,0.4392033542976939,2,FailT,10,10
199600548,1996,33,3,RIVERSIDE,1996-11-05,MURRIETA VALLEY UNIFIED SCHOOL DISTRICT,0,M,S,"In order to construct, acquire and improve permanent classrooms and educational sites and facilities, including science and technology centers, school libraries, classroom electrical systems for computers and other learning technology, shall the Murrieta Valley Unified School district incur bonded indebtedness in an mount not to exceed $30 million with an interest rate not to exceed the maximum rate allowed by law?",11,11,GO Bond,11,11,Education: Bonds,10255,5323,15578,0.6583001669020413,T,2,FailT,0,199600544,10255,5323,15578,0.6583001669020413,2,FailT,10,10
199600549,1996,33,3,RIVERSIDE,1996-11-05,SAN JACINTO UNIFIED SCHOOL DISTRICT,0,M,T,"Shall the San Jacinto Unified School District be authorized to issue bonds in the maximum amount not to exceed Six Million Five Hundred Thousand Dollars ($6,500,000) at a rate not to exceed the statutory maximum to construct a new middle school and to become eligible to receive state matching funds?",11,11,GO Bond,11,11,Education: Bonds,4678,2215,6893,0.6786595096474685,T,1,PassT,0,199600545,4678,2215,6893,0.6786595096474685,1,PassT,10,10
199600550,1996,34,3,SACRAMENTO,1996-11-05,SACRAMENTO CITY UNIFIED SCHOOL DISTRICT,0,M,E,"Shall the Sacramento City Unified School District incur bonded indebtedness of not to exceed Two Hundred Twenty-Five Million Dollars ($225,000,000), the rate of interest thereon not to exceed the maximum rate allowable by law, with no bond funds used for district administration sites, to improve, renovate and replace existing local school buildings, upgrade classrooms for new technologies, and meet mandated safety requirements?",11,11,GO Bond,11,11,Education: Bonds,61478,31077,92555,0.6642320782237588,T,2,FailT,0,199600546,61478,31077,92555,0.6642320782237588,2,FailT,10,10
199600551,1996,36,3,SAN BERNARDINO,1996-11-05,BARSTOW UNIFIED SCHOOL DISTRICT,0,M,W,"Shall the merit (civil service) system for school employees not requiring certification qualifications, as provided for in Article 6 (commencing with section 45240) of Chapter 5 of Part 25, of Division 3 of Title 2 of the Education Code of the State of California, and which has been in operation for at least five years, be terminated by the Barstow Unified School District of San Bernardino County of December 1, 1996?",70,70,Ordinance,12,12,Education: Districts,2968,5235,8203,0.36181884676337933,M,2,Fail,0,199600547,2968,5235,8203,0.3618188467633793,2,Fail,70,10
199600552,1996,36,3,SAN BERNARDINO,1996-11-05,CHINO UNIFIED SCHOOL DISTRICT,0,M,X,"Shall the Chino Unified School District be authorized to issue bonds in the maximum amount not to exceed $85 million at a rate not to exceed the statutory maximum to acquire, construct, modernize and expand school facilities, to reduce overcrowding, add classrooms and facilities, to upgrade outdated plumbing and electrical systems, to remove asbestos, and to provide students with access to modern classrooms and computer technology?",11,11,GO Bond,11,11,Education: Bonds,17900,15476,33376,0.536313518696069,T,2,FailT,0,199600548,17900,15476,33376,0.536313518696069,2,FailT,10,10
199600553,1996,36,3,SAN BERNARDINO,1996-11-05,VICTOR VALLEY UNION HIGH SCHOOL DISTRICT,0,M,Y,Shall students residing within the boundaries of Adelanto School District withdraw from the junior high school system (7th and 8th grade) maintained by the Victor Valley Union High School District?,70,70,Ordinance,11,11,Education: Bonds,14600,6075,20675,0.7061668681983071,M,1,Pass,0,199600549,14600,6075,20675,0.7061668681983071,1,Pass,70,10
199600554,1996,40,3,SAN LUIS OBISPO,1996-11-05,PASO ROBLES JOINT UNIFIED SCHOOL DISTRICT-PROPOSED,0,M,F,"Shall the Paso Robles Joint Union High School District and the Paso Robles Union Elementary School District be unified to form the Paso Robes Joint Unified School District, while preserving the San Miguel Joint Union School District and Pleasant Valley Joint Union elementary School District as separate elementary school districts?",70,70,Ordinance,12,12,Education: Districts,9657,2098,11755,0.821522756273926,M,1,Pass,1,199600550,9684,2113,11797,0.8208866661015513,1,Pass,70,10
199600555,1996,40,3,SAN LUIS OBISPO,1996-11-05,SAN LUIS OBISPO COMMUNITY COLLEGE DISTRICT,0,M,G,Shall Trustee Areas and the election of one member of the Governing Board of the San Luis Obispo County Community College District residing in each Trustee Area elected by the registered voters of the entire San Luis Obispo County Community College District be established?,70,70,Ordinance,12,12,Education: Districts,46458,31590,78048,0.5952490774907749,M,1,Pass,1,199600551,46550,31640,78190,0.5953446732318711,1,Pass,70,10
199600556,1996,41,3,SAN MATEO,1996-11-05,RAVENSWOOD CITY ELEMENTARY SCHOOL DISTRICT,0,M,U,"To provide local students with comprehensive library/reading centers, repair leaky roofs, replace inadequate heating, ventilation and 40-year old plumbing systems, provide safe classrooms, playgrounds and playing fields, acquire, construct and renovate classrooms and school facilities throughout the District for student and community use, shall the Ravenswood City School District issue $6 million of bonds, at an interest rate within the legal limit?",11,11,GO Bond,11,11,Education: Bonds,4112,624,4736,0.8682432432432432,T,1,PassT,0,199600552,4112,624,4736,0.8682432432432432,1,PassT,10,10
199600557,1996,41,3,SAN MATEO,1996-11-05,SEQUOIA UNION HIGH SCHOOL DISTRICT,0,M,V,"To modernize and upgrade local high schools, shall the Sequoia Union High School District be authorized to incur bonded indebtedness of $45,000,000 at interest rates not exceeding the legal limit for repairing deteriorating schools roofs, restrooms, and electrical and plumbing systems; removing asbestos; making earthquake safety improvements; modernizing classrooms, science labs, and vocational training facilities; upgrading classrooms for computers and other learning technologies; and constructing school facilities necessary for increased enrollment?",11,11,GO Bond,11,11,Education: Bonds,65253,17077,82330,0.7925786469087818,T,1,PassT,0,199600553,65253,17077,82330,0.7925786469087818,1,PassT,10,10
199600558,1996,42,3,SANTA BARBARA,1996-11-05,COLD SPRING SCHOOL DISTRICT,0,M,O96,"In order to replace existing portable classrooms with permanent classrooms, construct additional classrooms and school facilities including a multi-purpose room for instruction, meetings, performances, and physical education activities, renovate community athletic and playing fields, and provide for handicapped access, shall the Cold Spring School District incur bonded indebtedness in an amount not to exceed $2.9 million with an interest rate not to exceed the maximum rate allowed by law?",11,11,GO Bond,11,11,Education: Bonds,1446,386,1832,0.7893013100436681,T,1,PassT,0,199600554,1446,386,1832,0.7893013100436681,1,PassT,10,10
199600559,1996,42,3,SANTA BARBARA,1996-11-05,COLLEGE ELEMENTARY SCHOOL DISTRICT,0,M,P96,"In order to provide for the rehabilitation of existing classrooms and the acquisition and construction of educational facilities, including science and computer labs, shall the College Elementary School District incur bonded indebtedness not to exceed $8.1 million with an interest rate not to exceed the maximum rate allowed by law, so long as no bond money is used for salaries?",11,11,GO Bond,11,11,Education: Bonds,1677,1269,2946,0.5692464358452138,T,2,FailT,0,199600555,1677,1269,2946,0.5692464358452138,2,FailT,10,10
199600560,1996,42,3,SANTA BARBARA,1996-11-05,GOLETA UNION SCHOOL DISTRICT,0,M,M96,"In order to renovate and rehabilitate existing facilities including the repair of leaky roofs at older schools, construct new classrooms to reduce overcrowding, improve and upgrade school libraries, upgrade classroom electrical systems for computers and other learning technology, provide for handicapped access and provide funding for health and safety improvements at all of its schools, shall the Goleta Union School District incur bonded indebtedness in an amount not to exceed $26 million with an interest rate not to exceed the maximum rate allowed by law, so long as no bond funds are used for administrative salaries?",11,11,GO Bond,11,11,Education: Bonds,21768,7670,29438,0.7394524084516612,T,1,PassT,0,199600556,21768,7670,29438,0.7394524084516612,1,PassT,10,10
199600561,1996,42,3,SANTA BARBARA,1996-11-05,LOS OLIVOS ELEMENTARY SCHOOL DISTRICT,0,M,K96,"In order to provide science and computer labs, construct permanent classrooms and a multipurpose room for educational and community uses, and to rehabilitate existing school facilities, shall the Los Olivos Elementary School District incur bonded indebtedness in an amount not to exceed $2.4 million with an interest rate not to exceed the maximum allowed by law?",11,11,GO Bond,11,11,Education: Bonds,570,195,765,0.7450980392156863,T,1,PassT,0,199600557,570,195,765,0.7450980392156863,1,PassT,10,10
199600562,1996,44,3,SANTA CRUZ,1996-11-05,SAN LORENZO VALLE UNIFIED SCHOOL DISTRICT,0,M,G,"To improve, maintain, and make safe its public recreational facilities, thereby freeing up district resources to continue after school athletic programs and current library hours, and to construct, operate and maintain a community swimming pool, shall the San Lorenzo Valley Unified School District levy in its Recreation and Improvement Assessment District an annual assessment per parcel not to exceed that rate of $49.70 per single family equivalent unit as set forth in the District Engineer's report?",30,30,Advisory,12,12,Education: Districts,6677,5001,11678,0.5717588628189758,M,1,Pass,0,199600558,6677,5001,11678,0.5717588628189758,1,Pass,30,10
199600563,1996,45,3,SHASTA,1996-11-05,MOUNTAIN UNION SCHOOL DISTRICT,0,M,A,For decreasing the number of members of the governing board of the Mountain Union School District from seven to five.,70,70,Ordinance,12,12,Education: Districts,295,230,525,0.5619047619047619,M,1,Pass,0,199600559,295,230,525,0.5619047619047619,1,Pass,70,10
199600564,1996,49,3,SONOMA,1996-11-05,BELLVUE UNION SCHOOL DISTRICT,0,M,A,"To reduce student overcrowding and to enable the Bellevue Union Elementary School District to comply with building and safety codes by making needed fire, health and safety improvements such as repair or replacement of leaking roofs and outdated heating and plumbing systems; to accommodate modern computer technology and to improve, acquire and construct school facilities and classrooms; shall the District incur bonded indebtedness in the amount of $11,000,000 to bear interest at rates not exceeding the statutory maximum?",11,11,GO Bond,11,11,Education: Bonds,2404,926,3330,0.721921921921922,T,1,PassT,0,199600560,2404,926,3330,0.721921921921922,1,PassT,10,10
199600565,1996,49,3,SONOMA,1996-11-05,HORICON SCHOOL DISTRICT,0,M,C,"In order to protect students from earthquake, fire, health and safety hazards; upgrade electrical and heating systems for energy efficiency; and enhance educational facilities, shall the Horicon Elementary School District issue bonds in an amount not to exceed $4,200,000, at interest rates not exceeding the amount allowable by law, to provide funds to construct and modernize classrooms and school district facilities?",11,11,GO Bond,11,11,Education: Bonds,533,217,750,0.7106666666666667,T,1,PassT,0,199600561,533,217,750,0.7106666666666667,1,PassT,10,10
199600566,1996,49,3,SONOMA,1996-11-05,SHORELINE JOINT UNIFIED SCHOOL DISTRICT,0,M,B,"SHORELINE UNIFIED SCHOOL DISTRICT QUALIFIED SPECIAL TAX ASSESSMENT FOR EDUCATION PROGRAMS.  Shall the Shoreline Unified School District provide funds to maintain and expand specific educational programs by levying a qualified special tax assessment of one hundred twenty dollars per year per assessor's parcel for a limited period of four (4) years, beginning July 1. 1997?",3,3,Property Tax,12,12,Education: Districts,772,461,1233,0.6261151662611517,T,2,FailT,1,199600562,2358,1062,3420,0.6894736842105263,1,PassT,1,10
199600567,1996,54,3,TULARE,1996-11-05,EXETER SCHOOLS UNIFICATION MEASURE,0,M,P,Shall a new unified school district be formed from the existing Exeter Union High School District and the Exeter Union Elementary School District?,70,70,Ordinance,12,12,Education: Districts,1392,2483,3875,0.3592258064516129,M,2,Fail,0,199600563,1392,2483,3875,0.3592258064516129,2,Fail,70,10
199600568,1996,56,3,VENTURA,1996-11-05,OXNARD UNION HIGH SCHOOL DISTRICT,0,M,Y,"In order to construct and acquire new classrooms and facilities to reduce overcrowding, upgrade school libraries, rehabilitate existing facilities including the repair of leaky roofs at older schools, expand career academies to train students for future employment, install security systems and lighting for improved safety, and upgrade classroom electrical systems for computers and other learning technology, shall the Oxnard Union High School District incur bonded indebtedness in an amount not to exceed $57 million with an interest rate not to exceed the maximum rate allowed by law so long as no bond moneys are used for administrative salaries?",11,11,GO Bond,11,11,Education: Bonds,46554,21949,68503,0.679590674860955,T,1,PassT,0,199600564,46554,21949,68503,0.679590674860955,1,PassT,10,10
199600569,1996,57,3,YOLO,1996-11-05,ESPARTO UNIFIED SCHOOL DISTRICT,0,M,A,"In order to improve and modernize the aging high school facilities, to expand and improve the existing elementary school, to acquire land and to construct and create a new middle school, to renovate instructional program facilities, and to acquire land to expand and upgrade athletic fields, shall the Esparto Unified School District incur bonded indebtedness in an amount not to exceed $3.3 million with an interest rate not to exceed the maximum rate allowed by law?",11,11,GO Bond,11,11,Education: Bonds,1147,380,1527,0.7511460379829733,M,1,Pass,0,199600565,1147,380,1527,0.7511460379829732,1,Pass,10,10
199600570,1996,19,2,LOS ANGELES,1996-12-17,HAWIIAN GARDENS,0,R,1,Shall Robert J. Prida be recalled (removed) from the office of Member of the City Council?,50,50,Recall,48,46,Governance: Recall,689,663,1352,0.5096153846153846,M,1,Pass,0,199600566,689,663,1352,0.5096153846153846,1,Pass,50,40
199600571,1996,19,2,LOS ANGELES,1996-12-17,HAWIIAN GARDENS,0,R,2,Shall Lupe A. Cabrera be recalled (removed) from the office of Member of the City Council?,50,50,Recall,48,46,Governance: Recall,572,741,1313,0.4356435643564357,M,2,Fail,0,199600567,572,741,1313,0.43564356435643564,2,Fail,50,40
199600572,1996,19,2,LOS ANGELES,1996-12-17,HAWIIAN GARDENS,0,R,3,Shall Robert J. Canada be recalled (removed) from the office of Member of the City Council?,50,50,Recall,48,46,Governance: Recall,649,669,1318,0.49241274658573597,M,2,Fail,0,199600568,649,669,1318,0.49241274658573597,2,Fail,50,40
199600573,1996,19,2,LOS ANGELES,1996-12-17,HAWIIAN GARDENS,0,R,4,Shall Kathleen M. Navejas be recalled (removed) from the office of Member of the City Council?,50,50,Recall,48,46,Governance: Recall,973,356,1329,0.7321294206170054,M,1,Pass,0,199600569,973,356,1329,0.7321294206170053,1,Pass,50,40
