MeasID,YEAR,CO,JUR,CNTYNAME,DATE,PLACE,CSD,MEASTYPE,LTR,Ballotquestion,RECTYPE,RECTYPENAME,RECTOPIC,RECTOPNAME,YES,NO,TOTAL,PERCENT,REQ,OUTCOME,PASSFAIL,Multi_CO,Multi_MeasID,YES_sum,NO_sum,Total_sum,Percent_sum,Outcome_sum,passfail_sum,typerec,topicrec
201700001,2017,5,1,CALAVERAS,2017-05-02,Copper Cove Rocky Road CSD,1,M,D,"To maintain Copper Cove Rocky Road Community Service District roads shall a new tax, replacing the existing tax of $350 per residential lot, be adopted without expiration, at $450 per residential lot?",3,Property Tax,112,Revenues: Tax Creation/Incr./Contin.,87,151,238,0.36554621848739494,T,2,FailT,0,201700001,87,151,238,0.36554621848739494,2,FailT,1,110
201700002,2017,5,1,CALAVERAS,2017-05-02,Saddle Creed CSD,1,M,A,"To maintain Saddle Creek Community Services District owned facilities and easements including sidewalks, storm drains, landscaping, lighting, parks, security, weed and mosquito abatement, road improvement and maintenance, reserves, and administration, shall a new tax, providing $1.2 million annually and replacing the existing tax, be adopted without expiration at $1,703 per residential lot; $720 per acre for large lot undeveloped property; $640 per acre for sports club property; and $63,860 for the golf course property, including an annual CPI adjustment?",3,Property Tax,76,Facilities: Sports Facilities,191,85,276,0.6920289855072463,T,1,PassT,0,201700002,191,85,276,0.6920289855072463,1,PassT,1,70
201700003,2017,6,1,COLUSA,2017-11-07,Cortina CSD,1,M,A,"Upon adoption by the majority of registered voters in the Cortina Community Services District, shall the board of Directors of the Cortina Community Services District (currently the County Board of Supervisors) be changed to a Board of Directors elected at large by registered voters of the district with such directors taking office if the measure is passed by a majority vote?",70,Ordinance,43,Governance: Organization,42,10,52,0.8076923076923077,M,1,Pass,0,201700003,42,10,52,0.8076923076923077,1,Pass,70,40
201700004,2017,9,1,EL DORADO,2017-06-06,El Dorado CSD,1,M,A,"Shall the Board of Directors of the Marble Mountain Community Services District be authorized to annually assess each parcel located within the District which is not included within the boundaries of Road Improvement Zone “1”, (along Marble Ridge Road and Diablo Trail), a special tax in an amount up to, but not exceeding the amount of $400 per parcel to be expended for the maintenance and improvement of roadways located in those areas of the District lying outside of Road Improvement Zone “1”?",3,Property Tax,62,Transport: Roads,18,10,28,0.6428571428571429,T,2,FailT,0,201700004,18,10,28,0.6428571428571429,2,FailT,1,60
201700005,2017,9,1,EL DORADO,2017-11-07,Cosumnes River CSD,1,M,B,"The special tax to fund maintaining, upgrading and improving district roads of the Cosumnes River Community Services District (CRCSD) was set at $150.00 in 1991. Shall the CRCSD increase this tax by $150.00 such that the annual tax level is reset to $300.00 per parcel, to remain at that level unless and until there are further voter approved changes?",3,Property Tax,62,Transport: Roads,67,48,115,0.5826086956521739,T,2,FailT,0,201700005,67,48,115,0.5826086956521739,2,FailT,1,60
201700006,2017,19,1,LOS ANGELES,2017-03-07,Los Angeles,0,M,H,"To fund mental health, substance abuse treatment, health care, education, job training, rental subsidies, emergency and affordable housing, transportation, outreach, prevention, and supportive services for homeless children, families, foster youth, veterans, battered women, seniors, disabled individuals, and other homeless adults; shall voters authorize Ordinance No. 2017-0001 to levy a ¼ cent sales tax for ten years, with independent annual audits and citizens’ oversight?",4,Sales Tax,106,General Services: Social/Welfare,585905,259098,845003,0.6933762365340714,T,1,PassT,0,201700006,585905,259098,845003,0.6933762365340714,1,PassT,1,100
201700007,2017,20,1,MADERA,2017-03-07,Madera,0,M,L,"Shall Madera County enact a one percent public safety sales tax in the unincorporated area of the County to: Improve firefighting services throughout the county; Increase the number of paid and volunteer firefighters; Improve instructional and training services for volunteer firefighters; and, Increase the number of sheriff deputies; with annual public audits and citizen oversight for a period of twenty years and all funds controlled locally pursuant to Ordinance No. 683?",4,Sales Tax,33,Safety: Fire,5268,6526,11794,0.4466677971850093,T,2,FailT,0,201700007,5268,6526,11794,0.4466677971850093,2,FailT,1,30
201700008,2017,21,1,MARIN,2017-05-02,CSA #16,1,M,A,"Shall the special tax for maintenance and improvements to landscaped medians levied annually upon each improved parcel located within County Service Area #16 (Greenbrae), be increased from $150 per year to $300 per year per improved parcel within that area commencing with the 2017-2018 fiscal year?",3,Property Tax,105,General Services: Maintenance,495,526,1021,0.48481880509304603,T,2,FailT,0,201700008,495,526,1021,0.48481880509304603,2,FailT,1,100
201700009,2017,23,1,MENDOCINO,2017-11-07,Mendocino,0,M,B,"To provide funding for mental health care and facilities in Mendocino County to diagnose and treat mental illness and addiction, shall a transactions and use tax of one-half cent be enacted for five years, and thereafter reduced to one-eighth cent, with annual audits and a citizen's oversight committee to ensure funds are properly spent, and a requirement that funds cannot be taken by the State and spent for other purposes?",4,Sales Tax,106,General Services: Social/Welfare,15775,3111,18886,0.8352748067351478,T,1,PassT,0,201700009,15775,3111,18886,0.8352748067351478,1,PassT,1,100
201700010,2017,27,1,MONTEREY,2017-08-29,East Garrison CSD,1,M,D,Shall the East Garrison Community Services District have a directly elected Board of Directors?,70,Ordinance,43,Governance: Organization,13,288,301,0.04318936877076412,M,2,Fail,0,201700010,13,288,301,0.04318936877076412,2,Fail,70,40
201700011,2017,29,1,NEVADA,2017-03-07,Mystic Mine Road CSD,1,M,D,"Shall Resolution 2016-03 be approved establishing a special tax on each parcel of land within the District in the amount of $200.00 per year, beginning with the 2017-18 fiscal year, and $250.00 per year beginning with the 2021-22 fiscal year, and each fiscal year thereafter, for the purpose of funding road maintenance programs within the District, and further establish a spending limit in accordance with the provisions of Ariticle XIIIB of the California Constitution?",3,Property Tax,62,Transport: Roads,71,13,84,0.8452380952380952,T,1,PassT,0,201700011,71,13,84,0.8452380952380952,1,PassT,1,60
201700012,2017,36,1,SAN BERNARDINO,2017-03-07,Wrightwood CSD-Proposed,1,M,C,"Shall the order adopted on July 20, 2016, by the Local Agency Formation Commission for San Bernardino County ordering the reorganization to include formation of the Wrightwood Community Services District and Dissolution of County Service Area 56, known as LAFCO 3202, be approved subject to the terms and conditions as more particularly described in the order?",70,Ordinance,44,Governance: Incorporation/Formation/Annexation,573,337,910,0.6296703296703297,M,1,Pass,0,201700012,573,337,910,0.6296703296703297,1,Pass,70,40
201700013,2017,49,1,SONOMA,2017-03-07,Sonoma,0,M,A,"Shall an ordinance be adopted imposing a cannabis business tax in unincorporated Sonoma County on cultivation up to $38 per square foot (annually adjusted by CPI increases) or 10% on gross receipts, and on other cannabis businesses up to 10% on gross receipts, to fund essential county services such as addressing industry impacts, public safety, fire, health, housing, roads, and environmental protection, with funds staying local and subject to audits, generating undetermined revenue until repealed?",2,Business Tax,112,Revenues: Tax Creation/Incr./Contin.,64177,26219,90396,0.7099539802646134,M,1,Pass,0,201700013,64177,26219,90396,0.7099539802646134,1,Pass,1,110
201700014,2017,50,1,STANISLAUS,2017-11-07,Stanislaus,0,M,S,"To maintain local library funding the State cannot take, keep branches open, maintain hours, provide programs for children, teens, adults and seniors, children’s story times, literacy, homework and job search resources, maintain books, CDs, DVDs and reference materials -- shall Stanislaus County extend the existing one-eighth percent library sales tax for 12 years, commencing July 1, 2018, generating approximately $10 million annually, with an independent citizens oversight committee ensuring funds are spent only on Stanislaus County Libraries?",4,Sales Tax,71,Facilities: Libraries,41986,9025,51011,0.8230773754680363,T,1,PassT,0,201700014,41986,9025,51011,0.8230773754680363,1,PassT,1,70
201700015,2017,9,2,EL DORADO,2017-11-07,South Lake Tahoe,0,M,C,"To fix potholes and pave/repair/maintain local roads; improve safety for drivers/pedestrians/bicyclists; provide safe routes to school; and protect the clarity of Lake Tahoe by reducing sediment from roadways, shall an ordinance establishing a one-half percent sales tax be adopted for fifteen years, providing approximately $2.5 million annually in locally controlled funding for the Roads Management Authority of the City of South Lake Tahoe, requiring an independent citizens’ oversight committee and all funds for road improvement only?",4,Sales Tax,62,Transport: Roads,1497,1312,2809,0.5329298682805269,T,2,FailT,0,201700015,1497,1312,2809,0.5329298682805269,2,FailT,1,60
201700016,2017,10,2,FRESNO,2017-08-29,Mendota,0,M,A,"To support local law enforcement activities, shall an ordinance be adopted imposing an annual special parcel tax amounting to: (i) $400/unit upon developed multi-family residences or apartments; (ii) $500/unit upon all other developed parcels; (iii) $100/ unit upon developed parcels for senior citizens; (iv) $50/unit upon undeveloped parcels for senior citizens; and (v) $100/ parcel for all other undeveloped parcels?",3,Property Tax,32,Safety: Police,83,176,259,0.3204633204633205,T,2,FailT,0,201700016,83,176,259,0.3204633204633205,2,FailT,1,30
201700017,2017,10,2,FRESNO,2017-08-29,Mendota,0,M,B,"To provide additional funding for local law enforcement services, shall the ordinance increasing the City’s Sales and Use Tax from .980% to 1.980% which will raise approximately $500,000 annually be adopted?",4,Sales Tax,32,Safety: Police,108,151,259,0.416988416988417,T,2,FailT,0,201700017,108,151,259,0.416988416988417,2,FailT,1,30
201700018,2017,10,2,FRESNO,2017-11-07,Coalinga,0,M,C,"To help prevent the loss of vital public safety services, and to protect other general services, shall the City of Coalinga enact a general-purpose, one-percent sales tax, expected to generate $850,000 annually, with annual independent audits?",4,Sales Tax,112,Revenues: Tax Creation/Incr./Contin.,545,582,1127,0.4835847382431233,M,2,Fail,0,201700018,545,582,1127,0.4835847382431233,2,Fail,1,110
201700019,2017,12,2,HUMBOLDT,2017-11-07,Rio Dell,0,M,X,"Shall the ordinance creating a new business tax of up to give dollars per square foot of space utilized for certain commercial cannabis cultivation activity and, for other commercial cannabis activity, a tax of up to ten percent of gross receipts be adopted, with all proceeds placed in the City's General Fund to be used for any governmental purpose? The tax imposed by this Ordinance is expected to generate $980,000 in annual revenue and will continue in effect until later repealed",2,Business Tax,112,Revenues: Tax Creation/Incr./Contin.,353,83,436,0.8096330275229358,T,1,PassT,0,201700019,353,83,436,0.8096330275229358,1,PassT,1,110
201700020,2017,13,2,IMPERIAL,2017-11-07,Brawley,0,M,W,"Shall the City of Brawley ordinance extending the Utility Users Tax for five years at a rate not to exceed 4%, upon the use of telephone, electricity, gas, water, sewer, trash and cable television utilities, to maintain city services, including, but not limited to, police, fire, administration, library and parks and recreation, and subject to future council action to reduce said percentage, and which is projected to raise $1.9 million per year, be adopted?",5,Utility Tax,112,Revenues: Tax Creation/Incr./Contin.,1649,1010,2659,0.6201579541180895,M,1,Pass,0,201700020,1649,1010,2659,0.6201579541180895,1,Pass,1,110
201700021,2017,13,2,IMPERIAL,2017-11-07,Brawley,0,M,X,Shall the office of City Treasurer which is currently an elected position be consolidated with the position of City Finance Director and be converted to a position to be filled by City Council appointment commencing upon the expiration of the term of the current City Treasurer?,70,Ordinance,43,Governance: Organization,1312,1247,2559,0.5127002735443532,M,1,Pass,0,201700021,1312,1247,2559,0.5127002735443532,1,Pass,70,40
201700022,2017,15,2,KERN,2017-06-06,California City,0,M,A,"To fund general municipal expenses such as police, fire, urgent care, roads and recreation, shall the City tax cannabis (marijuana) businesses at annual rates not to exceed $7.00 per canopy square foot for cultivation (adjustable for inflation) and not to exceed 6% of gross receipts for all other cannabis businesses; which is expected to generate an estimated $3.4 million annually and will be levied until repealed by the voters or the City Council?",2,Business Tax,112,Revenues: Tax Creation/Incr./Contin.,1183,393,1576,0.7506345177664975,M,1,Pass,0,201700022,1183,393,1576,0.7506345177664975,1,Pass,1,110
201700023,2017,15,2,KERN,2017-06-06,California City,0,M,B,"In order to fund police, fire, and code enforcement services, shall the existing special parcel tax be extended for an additional three years (through tax year 2020-2021) at a rate not to exceed the existing rate of $150 per lot or parcel, generating approximately $7.5 Million in annual funding for public safety?",3,Property Tax,34,Safety: Multiple Emergency Services,727,848,1575,0.4615873015873016,T,2,FailT,0,201700023,727,848,1575,0.4615873015873016,2,FailT,1,30
201700024,2017,16,2,KINGS,2017-06-06,Corcoran,0,M,A,"To preserve the safety and character of Corcoran, and maintain essential general City services for Corcoran residents including police, 911 emergency response, fire protection, disaster preparedness, recreational programs and facilities, park maintenance and improvements, street maintenance and repairs and other essential services, shall Ordinance No. 631, imposing a 1 cent general sales and use tax, be adopted? Estimated revenues between $1,000,000 and $1,200,000 annually, indefinitely.",4,Sales Tax,112,Revenues: Tax Creation/Incr./Contin.,466,332,798,0.5839598997493735,M,1,Pass,0,201700024,466,332,798,0.5839598997493735,1,Pass,1,110
201700025,2017,19,2,LOS ANGELES,2017-03-07,Bell,0,M,T,"Shall the ordinance, to permit the Council to levy generally on visitors to the City a maximum 12% tax on hotel/motel charges, estimated to annually raise $285,000 for general City purposes, including for law enforcement and street repairs, and without a sunset clause, be adopted?",9,Transient Occupancy Tax,112,Revenues: Tax Creation/Incr./Contin.,1136,563,1699,0.6686286050618011,M,1,Pass,0,201700025,1136,563,1699,0.6686286050618011,1,Pass,1,110
201700026,2017,19,2,LOS ANGELES,2017-03-07,Bellflower,0,M,B,Shall the proposition imposing a tax on cannabis related businesses operating within the City of Bellflower be adopted?,2,Business Tax,112,Revenues: Tax Creation/Incr./Contin.,3159,1119,4278,0.738429172510519,M,1,Pass,0,201700026,3159,1119,4278,0.738429172510519,1,Pass,1,110
201700027,2017,19,2,LOS ANGELES,2017-03-07,Covina,0,M,CC,"To continue to provide about $5 million annually to preserve essential City services like Police, Fire, Parks, Library, Recreation and Public Works and other local programs and general services, shall an ordinance be adopted to extend the City of Covina's current 6% utility users tax on telephone, gas, electricity and water services to March of 2029, without raising the rate of the tax or taxing any additional utility services?",5,Utility Tax,112,Revenues: Tax Creation/Incr./Contin.,2740,1098,3838,0.7139134966128192,M,1,Pass,0,201700027,2740,1098,3838,0.7139134966128192,1,Pass,1,110
201700028,2017,19,2,LOS ANGELES,2017-03-07,Cudahy,0,M,PS,"Shall the 2017 Temporary Public Safety Funding Ordinance imposing an excise tax of $139 per parcel per year on single-family and unimproved property; $181 per dwelling per year on multifamily property; and between $1,550 to $49,600 per parcel per year on industrial, commercial, mobilehome park and other nonresidential properties be adopted for 5 years to raise approximately $2,000,000 per year to pay for approximately half of the City's annual cost of providing police protection services?",3,Property Tax,32,Safety: Police,333,925,1258,0.2647058823529412,T,2,FailT,0,201700028,333,925,1258,0.2647058823529412,2,FailT,1,30
201700029,2017,19,2,LOS ANGELES,2017-03-07,Los Angeles,0,M,M,"Shall an ordinance providing for enforcement, taxation and regulation of cannabis and/or cannabis products (cannabis) by: 1) providing that the City Council retains the authority to amend existing and adopt new regulations regarding cannabis activity in the City after conducting public hearings regarding various aspects of the commercialization of cannabis and medical cannabis, and giving priority in the processing of applications to existing medical marijuana dispensaries operating in compliance with current City law; 2) authorizing criminal penalties, nuisance abatement, increased civil fines and disconnection of water and power utilities for unauthorized cannabis activities; and 3) establishing new business taxes, effective January 1, 2018, including taxes of $100 per each $1,000 of gross receipts from cannabis sales and $50 per each $1,000 of gross receipts from medical cannabis sales, $10 per each $1,000 of gross receipts from cannabis transportation, testing or research, and $20 per each $1,000 of gross receipts from cannabis manufacturing, cultivation or other commercialization of cannabis; be adopted?",2,Business Tax,112,Revenues: Tax Creation/Incr./Contin.,319017,77523,396540,0.8045014374338024,M,1,Pass,0,201700029,319017,77523,396540,0.8045014374338024,1,Pass,1,110
201700030,2017,19,2,LOS ANGELES,2017-03-07,Los Angeles,0,M,N,"Shall an ordinance establishing a City permitting program for cannabis activity, prioritizing existing medical marijuana businesses compliant with current City law (MMBs) and maintaining 135 dispensaries in the City unless increased by the City Council, including by: 1) authorizing the City to issue permits for cannabis activity including cultivation, manufacture and sale of medical cannabis; 2) providing existing compliant MMBs a limited time to register for initial permits for specified cannabis activity and other priority in the permitting process; 3) allowing permitted cannabis activity in certain non-residential zones; 4) providing operational standards and minimum-distance requirements from schools and other sites; 5) authorizing fines and other penalties for non-permitted cannabis activity but limit enforcement procedures for violations of the ordinance by permit holders; and 6) allowing permittees to operate as adult use marijuana businesses and impose a tax of $80 per each $1,000 of gross receipts from adult use marijuana sales if state law changes to allow non-medical adult use of marijuana; be adopted?",2,Business Tax,22,Land Use: Zoning,134787,250896,385683,0.3494761241745164,M,2,Fail,0,201700030,134787,250896,385683,0.3494761241745164,2,Fail,1,20
201700031,2017,19,2,LOS ANGELES,2017-03-07,Los Angeles,0,M,P,"Shall the City Charter be amended to increase the maximum term for franchises, concessions, permits, licenses and leases that may be entered into by the Harbor Department from the current maximum of 50 years to a new maximum of 66 years, to be consistent with recent changes to state law?",20,Charter Amendment,20,Land Use,251398,116059,367457,0.6841562414105596,M,1,Pass,0,201700031,251398,116059,367457,0.6841562414105596,1,Pass,20,20
201700032,2017,19,2,LOS ANGELES,2017-03-07,Los Angeles,0,M,S,"Shall an ordinance amending City laws related to the General Plan, including to: 1) impose a two-year moratorium on projects seeking General Plan amendments or zone or height-district changes resulting in more intense land use, an increase in density or height, or a loss of zoned open space, agricultural or industrial areas, with exceptions including for affordable housing projects and projects for which vested rights have accrued; 2) prohibit geographic amendments to the General Plan unless the affected area has significant social, economic or physical identity (defined as encompassing an entire community or district plan area, specific plan area, neighborhood council area or at least 15 acres); 3) require systematic, public review of the General Plan every five years; 4) prohibit project applicants from completing environmental impact reports for the City; 5) require the City make findings of General Plan consistency for planning amendments, project approvals and permit decisions; and 6) prohibit certain parking variances; be adopted?",70,Ordinance,22,Land Use: Zoning,121101,288012,409113,0.296008682197828,M,2,Fail,0,201700032,121101,288012,409113,0.296008682197828,2,Fail,70,20
201700033,2017,19,2,LOS ANGELES,2017-03-07,Monterey Park,0,M,LL,Shall the proposition renewing a special parcel tax for library services at the Monterey Park Bruggemeyer Library be adopted?,3,Property Tax,71,Facilities: Libraries,2985,1954,4939,0.6043733549301478,T,2,FailT,0,201700033,2985,1954,4939,0.6043733549301478,2,FailT,1,70
201700034,2017,19,2,LOS ANGELES,2017-03-07,Palos Verdes Estates,0,M,D,"Shall an ordinance be adopted that continues a levy of the existing special tax for a period of twelve (12) years on each eligible parcel in the City at the initial base rate of $342.34 plus $0.196073 per square foot of building improvement effective July 1, 2017, and maintains the existing 6.2% limit on annual adjustments, initially generating approximately $4.7 million annually to finance fire suppression and paramedic services?",3,Property Tax,34,Safety: Multiple Emergency Services,2198,1470,3668,0.5992366412213741,T,2,FailT,0,201700034,2198,1470,3668,0.5992366412213741,2,FailT,1,30
201700035,2017,19,2,LOS ANGELES,2017-03-07,Redondo Beach,0,M,C,"Shall Redondo Beach approve amendments to its Coastal Land Use Plan Implementing Ordinance (partially adopted in 2010 in Measure G) to provide additional analytical procedures and additional limits reducing the amount and type of development in the Coastal Commercial Zones and the Parks, Recreation, and Open Space Zone (Seaside Lagoon), located in the Redondo Beach King Harbor-Pier area?",70,Ordinance,23,Land Use: Open Space,9229,6925,16154,0.5713136065370806,M,1,Pass,0,201700035,9229,6925,16154,0.5713136065370806,1,Pass,70,20
201700036,2017,19,2,LOS ANGELES,2017-03-07,San Fernando,0,M,SF,Shall the office of City Treasurer be appointive?,70,Ordinance,43,Governance: Organization,953,643,1596,0.5971177944862155,M,1,Pass,0,201700036,953,643,1596,0.5971177944862155,1,Pass,70,40
201700037,2017,19,2,LOS ANGELES,2017-03-07,Signal Hill,0,I,F,"(INITIATIVE) Shall the proposed citizen's intitative measure to tax medical marijuana facilities in the City of Signal Hill through a 10% tax on the monetary transactions as well as doubling the license taxes, with no sunset clause, and currently estimated to raise $0.00 annually because medical marijuana facilities are not presently allowed in the city of Signal Hill be adopted?",2,Business Tax,112,Revenues: Tax Creation/Incr./Contin.,534,605,1139,0.4688323090430202,M,2,Fail,0,201700037,534,605,1139,0.4688323090430202,2,Fail,1,110
201700038,2017,19,2,LOS ANGELES,2017-04-04,Glendale,0,M,L,Shall the City Charter be amended to require term limits for councilmembers: councilmembers may not serve more than three terms; a partial term of two years or more will be deemed a full term; and the measure will not apply to councilmember terms that commenced prior to adoption of this measure?,20,Charter Amendment,45,Governance: Political Reform/Term Limits,16707,2965,19672,0.8492781618544124,M,1,Pass,0,201700038,16707,2965,19672,0.8492781618544124,1,Pass,20,40
201700039,2017,19,2,LOS ANGELES,2017-04-04,Inglewood,0,M,DE,Shall the Inglewood City Charter be amended to allow the Board of Education for Inglewood City Schools to change the method of election of the Board of Education?,20,Charter Amendment,43,Governance: Organization,1654,1247,2901,0.5701482247500862,M,1,Pass,0,201700039,1654,1247,2901,0.5701482247500862,1,Pass,20,40
201700040,2017,19,2,LOS ANGELES,2017-04-11,Vernon,0,M,Q,"Shall an ordinance be adopted to authorize the levy of a 6% utility users' tax on electricity, gas, telecommunications, video and water utility services, with  exemptions for residential services provided to persons with disabilities and low income households?",5,Utility Tax,112,Revenues: Tax Creation/Incr./Contin.,14,23,37,0.3783783783783784,M,2,Fail,0,201700040,14,23,37,0.3783783783783784,2,Fail,1,110
201700041,2017,19,2,LOS ANGELES,2017-05-16,Los Angeles,0,M,C,Shall the Charter be amended to allow the City Council to provide that a police officer who is entitled to a Police Department Board of Rights hearing for a disciplinary matter may select a Board of Rights composed of all civilian members?,20,Charter Amendment,42,Governance: Personnel/Labor Relations,113198,93296,206494,0.5481902621867948,M,1,Pass,0,201700041,113198,93296,206494,0.5481902621867948,1,Pass,20,40
201700042,2017,19,2,LOS ANGELES,2017-11-07,Carson,0,M,C,"To maintain and improve Carson services, such as 911 emergency, Sheriff protection, senior/youth/anti-gang programs; repair streets; improve air/environmental quality, reduce hazardous waste; shall an ordinance be adopted imposing tax of 1/4th of 1% of gross receipts of operators of facilities blending, mixing, processing, or refining petroleum or petroleum products and/or storing petroleum products, to provide approximately $24,000,000 anually until ended by voters, requiring regular compliance audits, with funds used in Carson?",2,Business Tax,112,Revenues: Tax Creation/Incr./Contin.,5894,2223,8117,0.7261303437230504,M,1,Pass,0,201700042,5894,2223,8117,0.7261303437230504,1,Pass,1,110
201700043,2017,19,2,LOS ANGELES,2017-11-07,Compton,0,M,A,"Shall the Compton City Charter be amended to set the salary of Council members to $43,000, and to set the Mayor's annual salary to $54,000?",20,Charter Amendment,42,Governance: Personnel/Labor Relations,887,2418,3305,0.26838124054462936,M,2,Fail,0,201700043,887,2418,3305,0.26838124054462936,2,Fail,20,40
201700044,2017,19,2,LOS ANGELES,2017-11-07,El Monte,0,M,EM,"To preserve and stabilize funding for various essential City services such as fire and emergency response services; police staffing; street maintenance; senior and youth programs; park maintenance; graffiti removal; State-mandated storm drain upgrades; and to restore the City's ""rainy day"" general fund reserves, shall the City's existing half percent (1/2%) transactions and use tax be extended for ten years, subject always to the voters' power of repeal?",4,Sales Tax,112,Revenues: Tax Creation/Incr./Contin.,2187,960,3147,0.6949475691134414,M,1,Pass,0,201700044,2187,960,3147,0.6949475691134414,1,Pass,1,110
201700045,2017,19,2,LOS ANGELES,2017-11-07,Hawthorne,0,M,HH,"To fund general city services, such as police, fire, senior services, streets, parks, paramedics, 9-1-1, anti-gang units, and other general city services, shall the City of Hawthorne Transactions and Use Tax Ordinance of 2017 be approved, imposing a 0.75% transactions and use (sales) tax, with annual audit and appointment of a Citizen's Oversight Committee, to be collected until repealed by the voters or the City Council and estimated to raise approximately $8.5 million per year?",4,Sales Tax,112,Revenues: Tax Creation/Incr./Contin.,2745,1239,3984,0.6890060240963856,M,1,Pass,0,201700045,2745,1239,3984,0.6890060240963856,1,Pass,1,110
201700046,2017,19,2,LOS ANGELES,2017-11-07,La Habra Heights,0,M,G,Shall an ordinance be adopted to renew the City's authority to spend existing revenues from the special fire tax approved by two-thirds of the City's voters in 1997 to provide essential fire and life safety services by renewing the voter-approved amendment to the City's appropriations limits?,70,Ordinance,33,Safety: Fire,844,169,1013,0.8331688055281342,M,1,Pass,0,201700046,844,169,1013,0.8331688055281342,1,Pass,70,30
201700047,2017,19,2,LOS ANGELES,2017-11-07,Montebello,0,M,S,"To preserve public safety, community programs and prevent significant cuts to essential services, by funding general City services including hiring additional police and fire personnel, maintaining anti-gang and graffiti efforts, youth and after-school parks and recreation services, expanding and improving City parks, fixing City streets and public infrastructure, shall the City sales tax be increased by one cent with annual financial audits, expenditure reports, and financial oversight?",4,Sales Tax,112,Revenues: Tax Creation/Incr./Contin.,1650,2720,4370,0.37757437070938216,M,2,Fail,0,201700047,1650,2720,4370,0.37757437070938216,2,Fail,1,110
201700048,2017,19,2,LOS ANGELES,2017-11-07,Montebello,0,M,T,"Shall the terms served by elected officials of the City of Montebello, including members of the City Council, the City Treasurer, and the City Clerk, be limited to not more than three (3) consecutive four (4) year terms, after which an elected official shall not be qualified to serve in that elected office for a period of four (4) years?",70,Ordinance,45,Governance: Political Reform/Term Limits,3652,652,4304,0.8485130111524164,M,1,Pass,0,201700048,3652,652,4304,0.8485130111524164,1,Pass,70,40
201700049,2017,19,2,LOS ANGELES,2017-11-07,Rolling Hills,0,M,C,Shall an ordinance be adopted repealing the March 2013 amendments made to the City's View Preservation Ordinance by Measure B?,70,Ordinance,20,Land Use,441,302,743,0.5935397039030955,M,1,Pass,0,201700049,441,302,743,0.5935397039030955,1,Pass,70,20
201700050,2017,19,2,LOS ANGELES,2017-11-07,Whittier,0,M,L,"To expand 58-year-old Whittier Central Library to meet 21st century needs, including: providing a children's area for story times, parent/child reading, and children's book collections/technology; improving senior/disabled access; expanding/updating computer/technology center; space for up-to-date book/resource collections; relocating the Veterans Resource Center for better service; and related improvements; shall the City of Whittier issue $22,000,000 in bonds at legal rates, requiring independent citizen oversight, and all funds for Whittier Central Library only?",11,GO Bond,71,Facilities: Libraries,4278,2160,6438,0.6644920782851818,T,2,FailT,0,201700050,4278,2160,6438,0.6644920782851818,2,FailT,10,70
201700051,2017,21,2,MARIN,2017-11-07,Larkspur,0,M,B,"To maintain City services, including repairing aging, deteriorating neighborhood streets, roads, potholes, major boulevards; clearing brush to prevent fires/improve emergency vehicle access; upgrading storm drains; fire protection/911 emergency/medical response; and other services, shall the City of Larkspur extend the voter-approved sales tax at the 3/4¢ rate until ended by voters, providing $1,650,000 annually with authority to incur debt to accelerate infrastructure projects, subject to citizens’ oversight/audits?",4,Sales Tax,112,Revenues: Tax Creation/Incr./Contin.,1945,976,2921,0.6658678534748373,M,1,Pass,0,201700051,1945,976,2921,0.6658678534748373,1,Pass,1,110
201700052,2017,21,2,MARIN,2017-11-07,Novato,0,M,D,"Shall the City of Novato adopt an ordinance amending the General Plan to continue the Urban Growth Boundary to December 31, 2042 and adopting policies and programs relating thereto be adopted?",70,Ordinance,21,Land Use: Growth Cap/Boundary,8933,3150,12083,0.7393031531904328,M,1,Pass,0,201700052,8933,3150,12083,0.7393031531904328,1,Pass,70,20
201700053,2017,27,2,MONTEREY,2017-01-24,Greenfield,0,R,1,"Shall JOHN HUERTA, JR. be recalled(removed) from the office of City Mayor?",50,Recall,46,Governance: Recall,866,554,1420,0.6098591549295774,M,1,Pass,0,201700053,866,554,1420,0.6098591549295774,1,Pass,50,40
201700054,2017,27,2,MONTEREY,2017-05-02,Greenfield,0,M,C,"To ensure fire and emergency medical services for our community, including the cost of qualified staff, capital replacement and reserves, shall a new parcel tax providing up to $770,000 initially, be adopted without expiration at up to $200 per single family unit, $150 per multi-unit, and $85 - $200 plus $.07 per building square foot for non- residential parcels, including an annual increase equal to the inflation index as established each year by the City Council?",2,Business Tax,34,Safety: Multiple Emergency Services,648,301,949,0.6828240252897787,T,1,PassT,0,201700054,648,301,949,0.6828240252897787,1,PassT,1,30
201700055,2017,27,2,MONTEREY,2017-06-06,Seaside,0,M,G,"To generate an estimated $300,000 annually until ended by voters to maintain essential City services such as 9-1-1 emergency response, anti-drug/anti-gang programs; repairing streets, potholes, storm drains; earthquake, flood preparedness; improving parks, youth/senior programs; and other general services; with required independent audits and all funds staying in Seaside, shall the ordinance levying an ongoing tax of up to 10% of gross receipts of marijuana businesses be adopted?",2,Business Tax,112,Revenues: Tax Creation/Incr./Contin.,1810,409,2219,0.8156827399729608,M,1,Pass,0,201700055,1810,409,2219,0.8156827399729608,1,Pass,1,110
201700056,2017,27,2,MONTEREY,2017-06-06,Seaside,0,M,L,"To generate an estimated $1,900,000 annually until ended by voters to maintain essential City services such as police, fire, 9-1-1 emergency response; hiring police officers/firefighters; youth violence prevention programs; improving street maintenance, water cleanliness, earthquake, flood preparedness, parks, beaches, youth/senior programs, and other general services; with required independent audits and all funds staying in Seaside; shall the ordinance increasing the City's sales tax by 1/2 cent be adopted?",4,Sales Tax,112,Revenues: Tax Creation/Incr./Contin.,1403,822,2225,0.630561797752809,M,1,Pass,0,201700056,1403,822,2225,0.630561797752809,1,Pass,1,110
201700057,2017,32,2,PLUMAS,2017-06-06,Portola,0,M,B,"Upon a 2/3 vote of approval shall the City of Portola be authorized and empowered to adopt Ordinance No. 345 establishing an annual special tax, for each parcel of real property within the City, to be collected and apportioned along with the County property taxes, without expiration commencing July 1, 2017, with an annual cost of living adjustment, to be used for providing and enhancing necessary fire protection, prevention and suppression services, emergency medical and rescue services and hazardous material emergency response services?",3,Property Tax,34,Safety: Multiple Emergency Services,151,274,425,0.3552941176470588,T,2,FailT,0,201700057,151,274,425,0.3552941176470588,2,FailT,1,30
201700058,2017,33,2,RIVERSIDE,2017-05-02,Lake Elsinore,0,I,A,"(INITIATIVE) Shall the Ordinance Initiative Measure Revising the Alberhill Villages Specific Plan Governing the Future Development of Approximately 1,400 Acres Located in Northwest Lake Elsinore, South of Interstate 15 and West of Lake Street be adopted?",40,Initiative,22,Land Use: Zoning,451,3378,3829,0.11778532253852181,M,2,Fail,0,201700058,451,3378,3829,0.11778532253852181,2,Fail,40,20
201700059,2017,33,2,RIVERSIDE,2017-11-07,Desert Hot Springs,0,M,B,"Shall the Ordinance preventing public safety service cuts to police/emergency response times, anti-gang/anti-drug, youth violence and sex offender/parolee programs, extending existing, voter-approved public safety measure at a reduced rate of $103 per single family residence, providing approximately $2,000,000 annually, until ended by voters, requiring audits, with all funds for local public safety, and a tax decrease for these parcels, be adopted?",3,Property Tax,30,Safety,1672,552,2224,0.7517985611510791,T,1,PassT,0,201700059,1672,552,2224,0.7517985611510791,1,PassT,1,30
201700060,2017,33,2,RIVERSIDE,2017-11-07,Desert Hot Springs,0,M,C,"Shall the Ordinance to increase police training, recruitment/retention and crime investigation/prevention; maintain rapid police, fire and 9-1-1 emergency response times; and to hire additional police officers to patrol streets, extending its existing, voter-approved utility users’ tax, producing approximately $2,831,543 annually, until ended by voters, with independent citizens’ oversight, annual audits, and requiring all funds for local public safety services be adopted?",5,Utility Tax,34,Safety: Multiple Emergency Services,1692,535,2227,0.7597665020206555,T,1,PassT,0,201700060,1692,535,2227,0.7597665020206555,1,PassT,1,30
201700061,2017,33,2,RIVERSIDE,2017-11-07,Palm Springs,0,M,D,"To maintain essential city services, including rapid 911 emergency response, fire/police protection, add paramedic services, keep fire stations open/staffed, address homelessness, repair local streets/pothales, improve rapid response to assault, burglaries/crimes, keep public areas safe/clean, maintain senior services, attract/retain jobs/business, increase water conservation; shall the City of Palm Springs establish a 1/2 cent sales tax; requiring annual independent audits/public oversight; all funds used locally?",4,Sales Tax,112,Revenues: Tax Creation/Incr./Contin.,6849,5289,12138,0.5642609985170539,T,2,FailT,0,201700061,6849,5289,12138,0.5642609985170539,2,FailT,1,110
201700062,2017,33,2,RIVERSIDE,2017-11-07,Palm Springs,0,M,E,"Shall Palm Springs update the existing gross receipts tax on medical cannabis collectives and cooperatives to apply to all medical and adult-use cannabis businesses, apart from cultivation businesses, which will be taxed at a rate up to 10 dollars per square foot, with all revenue used in Palm Springs to maintain and improve essential city services, including public safety and youth drug prevention education; requiring annual independent audits and public oversight?",2,Business Tax,112,Revenues: Tax Creation/Incr./Contin.,9357,2581,11938,0.7837996314290501,M,1,Pass,0,201700062,9357,2581,11938,0.7837996314290501,1,Pass,1,110
201700063,2017,33,2,RIVERSIDE,2017-11-07,Perris,0,M,G,"Shall the ordinance known as the SALE OF THE CITY OF PERRIS DOWNTOWN SEWER SYSTEM, authorizing the City of Perris to sell the Downtown Perris Sewer System to retire Water System debt and use the remaining proceeds for park amenities, including athletic fields, be adopted?",70,Ordinance,102,General Services: Wastewater/Sewage,1216,817,2033,0.5981308411214953,T,2,FailT,0,201700063,1216,817,2033,0.5981308411214953,2,FailT,70,100
201700064,2017,33,2,RIVERSIDE,2017-11-07,Perris,0,M,H,"Shall the resolution known as the SALE OF THE CITY OLF PERRIS NORTH PERRIS WATER SYSTEM AND DOWNTOWN PERRIS WATER SYSTEM, which will authorize the City of Perris to sell the North Perris Water System and Downtown Water System to Liberty Utilities to retire Water System debt and use the remaining proceeds for park amenities, including athletic fields, be adopted?",70,Ordinance,104,General Services: Water,1326,769,2095,0.6329355608591886,M,1,Pass,0,201700064,1326,769,2095,0.6329355608591886,1,Pass,70,100
201700065,2017,36,2,SAN BERNARDINO,2017-06-06,Apple Valley,0,M,F,"Shall the Town of Apple Valley be authorized to finance the acquisition of the Apple Valley water system, currently owned and operated by Liberty Utilities, including related expenses, by incurring debt in the maximum amount of $150,000,000, provided that the debt is repaid from revenues generated by the water system, and not from taxes, and further that the Town conducts an annual independent audit?",12,Revenue Bond,104,General Services: Water,7200,5238,12438,0.5788712011577424,M,1,Pass,0,201700065,7200,5238,12438,0.5788712011577424,1,Pass,10,100
201700066,2017,36,2,SAN BERNARDINO,2017-06-06,Upland,0,M,E,An ordinance repealing Chapter 9.48 of the City of Upland Municipal Code and replacing it with a new Chapter 9.48 prohibiting marijuana-related uses and activities in the city. Shall the voters of the City of Upland adopt an ordinance prohibiting marijuana-related uses and activities in the city?,70,Ordinance,22,Land Use: Zoning,7562,2805,10367,0.729429921867464,M,1,Pass,0,201700066,7562,2805,10367,0.729429921867464,1,Pass,70,20
201700067,2017,36,2,SAN BERNARDINO,2017-07-11,Chino,0,M,H,"Shall Ordinance No. 2017-004, entitled “An Ordinance of the People of the City of Chino, California, to Enact Section No. 20.15.160 of the Chino Municipal Code Converting 29.7 Acres From the General Plan Designation of RD 1 to RD 4.5, RD 8, and RD 12 Generally Located Between Vernon Avenue and Benson Avenue, South of Adams Street, and North of the Chino Promenade Shopping Center and rezoning the same from an RD 1 designation to RD 4.5, RD 8, RD 12 designations” be adopted?",70,Ordinance,22,Land Use: Zoning,1262,6695,7957,0.1586024883750157,M,2,Fail,0,201700067,1262,6695,7957,0.1586024883750157,2,Fail,70,20
201700068,2017,36,2,SAN BERNARDINO,2017-11-07,Barstow,0,M,J,"To provide long-term sustainability, adequate resources for emergency response, and more equitably spread the cost of Barstow Fire Protection District’s services across the population it serves, including 60,000,000 annual nonresident travelers who consume taxable goods and services in Barstow, shall an ordinance be adopted to increase the sales tax by one-half of one percent, providing $3.8 million dollars annually, expiring if the Barstow Fire Protection District is transferred to an agency outside the City?",4,Sales Tax,33,Safety: Fire,1342,715,2057,0.6524064171122995,T,2,FailT,0,201700068,1342,715,2057,0.6524064171122995,2,FailT,1,30
201700069,2017,36,2,SAN BERNARDINO,2017-11-07,Victorville,0,M,K,"To address crime issues, respond quickly to fires and medical emergencies, and make Victorville safer by adding 10 new police and 15 new firefighter/paramedics, shall Ordinance No. 2371 be adopted to impose a one-half percent (0.5%) transactions and use (“sales”) tax, estimated to raise $8.5 million annually, with all funds restricted to use on public safety services within Victorville?",4,Sales Tax,34,Safety: Multiple Emergency Services,3859,2397,6256,0.6168478260869565,T,2,FailT,0,201700069,3859,2397,6256,0.6168478260869565,2,FailT,1,30
201700070,2017,37,2,SAN DIEGO,2017-11-07,Poway,0,I,A,(INITIATIVE) Shall the ordinance changing the General Plan and Zoning Land Use Map to redesignate a portion of the Stoneridge Country Club from Open Space-Recreation to Residential Condominium with the Stoneridge Overlay Zone to allow for the development of not more than 180 residential condominium units for residents over the age of 55 be adopted?,40,Initiative,23,Land Use: Open Space,4486,7603,12089,0.37108114815121185,M,2,Fail,0,201700070,4486,7603,12089,0.37108114815121185,2,Fail,40,20
201700071,2017,40,2,SAN LUIS OBISPO,2017-08-22,San Luis Obispo,0,I,B-17,"(INITIATIVE) Shall an ordinance be adopted to replace former Chapter 15.10 of the San Luis Obispo Municipal Code, entitled ""Rental Housing Inspection"" (repealed by City Council Ordinance 1632, effective April 20, 2017), with new Chapter 15.10 to be entitled ""Non-Discrimination in Housing?",40,Initiative,80,Housing,2462,5849,8311,0.29623390687041273,M,2,Fail,0,201700071,2462,5849,8311,0.29623390687041273,2,Fail,40,80
201700072,2017,41,2,SAN MATEO,2017-06-06,Atherton,0,A,A,"(ADVISORY) Should the Town of Atherton supplement private donations with available non-dedicated General Funds to meet the funding shortfall, where one exists, for construction of the new Town Center?",30,Advisory,70,Facilities,1182,743,1925,0.614025974025974,M,1,Pass,0,201700072,1182,743,1925,0.614025974025974,1,Pass,30,70
201700073,2017,41,2,SAN MATEO,2017-11-07,Atherton,0,M,F,"To continue providing funding to maintain neighborhood police patrols and the Town's ability to respond to emergencies, repairing and maintaining streets, and repairing and constructing storm drains, shall an ordinance be adopted to continue a Special Parcel Tax for three years and allowing for the expenditure of funds derived from such tax?",3,Property Tax,112,Revenues: Tax Creation/Incr./Contin.,981,884,1865,0.5260053619302949,T,2,FailT,0,201700073,981,884,1865,0.5260053619302949,2,FailT,1,110
201700074,2017,41,2,SAN MATEO,2017-11-07,Brisbane,0,M,D,"To pay for general municipal expenses, shall the City impose an annual business license tax on a soil recycling establishment of up to twenty (20%) of its gross receipts or up to two hundred thousand dollars ($200,000), whichever is greater?",2,Business Tax,112,Revenues: Tax Creation/Incr./Contin.,831,275,1106,0.7513562386980108,M,1,Pass,0,201700074,831,275,1106,0.7513562386980108,1,Pass,1,110
201700075,2017,41,2,SAN MATEO,2017-11-07,Brisbane,0,M,E,"To pay for general municipal expenses, shall the City increase the annual business license tax for certain recycling establishments up to $4,000,000 (plus adjustments) per year?",2,Business Tax,112,Revenues: Tax Creation/Incr./Contin.,877,225,1102,0.7958257713248639,M,1,Pass,0,201700075,877,225,1102,0.7958257713248639,1,Pass,1,110
201700076,2017,41,2,SAN MATEO,2017-11-07,Burlingame,0,M,I,"To maintain/improve Burlingame's quality of life, including essential City facilities and services such as maintaining city streets, sidewalks and potholes; enhancing neighborhood police patrols/crime prevention programs, maintaining recreation programs and safe facilities for youth/teens; and other essential city services, shall the City of Burlingame enact an ongoing, 1/4 cent sales tax with authority to incur debt to accelerate infrastructure projects, providing $2,000,000 annually, with annual audits, independent citizens' oversight, and all funds spent locally?",4,Sales Tax,112,Revenues: Tax Creation/Incr./Contin.,3396,1977,5373,0.6320491345616974,M,1,Pass,0,201700076,3396,1977,5373,0.6320491345616974,1,Pass,1,110
201700077,2017,41,2,SAN MATEO,2017-11-07,Pacifica,0,M,C,"Shall the Ordinance entitled Pacifica Community Preservation, Rent Stabilization, and Renters' Rights Act which protects certain tenants of multi-family housing from excessive rent increases and no-fault evictions and ensures that Landlords receive a fair and reasonable rate of return on their investment, be adopted?",70,Ordinance,82,Housing: Rent Control,4354,6640,10994,0.39603420047298526,M,2,Fail,0,201700077,4354,6640,10994,0.39603420047298526,2,Fail,70,80
201700078,2017,41,2,SAN MATEO,2017-11-07,Pacifica,0,M,G,"Shall an ordinance establishing a Marijuana Operations Tax at the rate of 6% of a Marijuana Operation's gross receipts, which may be decreased or increased after two years to a maximum of 10% by the City Council, to help fund municipal services, including police and fire protection services, emergency medical services, park, recreation, and street maintenance services, with no sunset date and estimated to generate $360,000 annually in tax revenue, be adopted?",2,Business Tax,112,Revenues: Tax Creation/Incr./Contin.,8588,2316,10904,0.7876008804108584,M,1,Pass,0,201700078,8588,2316,10904,0.7876008804108584,1,Pass,1,110
201700079,2017,41,2,SAN MATEO,2017-11-07,San Mateo,0,M,B,"To conform with state law, shall the Charter amendment changing the timing of the city's general municipal elections from odd-numbered years to even-numbered years, and extending the terms of the council members elected in 2015 and 2017 for a period of one year, respectively, be adopted?",20,Charter Amendment,48,Governance: Elections,9726,2219,11945,0.8142318961908749,M,1,Pass,0,201700079,9726,2219,11945,0.8142318961908749,1,Pass,20,40
201700080,2017,41,2,SAN MATEO,2017-11-07,San Mateo,0,M,H,"Shall the charter amendment revising the City of San Mateo's charter to: allow for regular council meetings to be held at locations other than City Hall, when necessary; updating the title of Personnel Director to Human Resources Director; and revising the Fiscal Administration provisions to conform with state law and current practices be adopted?",20,Charter Amendment,43,Governance: Organization,9774,2167,11941,0.8185244116908131,M,1,Pass,0,201700080,9774,2167,11941,0.8185244116908131,1,Pass,20,40
201700081,2017,42,2,SANTA BARBARA,2017-11-07,Santa Barbara,0,M,C,"To maintain essential services and repair critical infrastructure including:  Police, fire, and 911 emergency medical response; local streets, potholes, bridges and storm drains; neighborhood f re stations/public safety infrastructure; parks, youth/senior services; address homelessness; help retain local businesses; support other general services; shall the City of Santa Barbara enact a one-cent sales tax providing approximately 22 million dollars annually unless ended by voters; requiring audits, citizens oversight, public disclosure of spending, and all funds used locally?",4,Sales Tax,112,Revenues: Tax Creation/Incr./Contin.,13501,10558,24059,0.5611621430649653,M,1,Pass,0,201700081,13501,10558,24059,0.5611621430649653,1,Pass,1,110
201700082,2017,43,2,SANTA CLARA,2017-04-25,Campbell,0,M,A,"Shall the ordinance levying a business license tax on marijuana businesses at the initial rate of 7% and a maximum rate of 15% of the gross receipts of the marijuana business be adopted to continue until repealed by the City Council or City voters, which is estimated to raise $130,000 - $260,000 annually for general City services, such as police, fire and code enforcement services?",2,Business Tax,34,Safety: Multiple Emergency Services,5582,1023,6605,0.8451173353520061,M,1,Pass,0,201700082,5582,1023,6605,0.8451173353520061,1,Pass,1,30
201700083,2017,43,2,SANTA CLARA,2017-04-25,Campbell,0,M,B,"Shall the ordinance allowing the City to license up to three medical marijuana dispensaries in Campbell, which would also be allowed to deliver medical marijuana to qualified patients throughout the City, and that would allow every qualified patient and primary caregiver to cultivate up to 100 square feet or 500 square feet of marijuana, respectively, without a license be adopted?",70,Ordinance,22,Land Use: Zoning,2398,4175,6573,0.364825802525483,M,2,Fail,0,201700083,2398,4175,6573,0.364825802525483,2,Fail,70,20
201700084,2017,43,2,SANTA CLARA,2017-04-25,Campbell,0,M,C,"Shall the ordinance imposing a moratorium on marijuana dispensaries in Campbell until at least April 1, 2019 be adopted, allowing time for study of traffic, neighborhood and safety issues, and providing the City Council discretion to allow for dispensaries after that date, provided that the dispensaries be at least 100 feet from residential properties and 600 feet from child care facilities, schools, parks and community centers, and other dispensaries?",70,Ordinance,22,Land Use: Zoning,4122,2411,6533,0.6309505587019746,M,1,Pass,0,201700084,4122,2411,6533,0.6309505587019746,1,Pass,70,20
201700085,2017,45,2,SHASTA,2017-08-29,Shasta Lake,0,M,A,"Shall an ordinance be adopted imposing a cannabis business tax on cultivation up to $26 per square foot, on manufacturing up to $25 per square foot, and on other cannabis businesses up to 12% gross receipts to provide funding for local law enforcement/code enforcement within the City of Shasta Lake?",2,Business Tax,32,Safety: Police,1240,325,1565,0.792332268370607,T,1,PassT,0,201700085,1240,325,1565,0.792332268370607,1,PassT,1,30
201700086,2017,49,2,SONOMA,2017-06-06,Santa Rosa,0,M,C,"Shall those provisions of the City of Santa Rosa Residential Rent Stabilization and Other Tenant Protections Ordinance that establish rent control for certain residential rental properties, prohibit landlords from evicting tenants of certain properties except for specified reasons, and provide other protections to tenants, be approved?",70,Ordinance,82,Housing: Rent Control,16382,17163,33545,0.4883589208525861,M,2,Fail,0,201700086,16382,17163,33545,0.4883589208525861,2,Fail,70,80
201700087,2017,49,2,SONOMA,2017-06-06,Santa Rosa,0,M,D,"Shall an ordinance be adopted authorizing a cannabis business tax in the City of Santa Rosa on cultivation businesses up to $25 per square foot of cultivation area (annually adjusted by CPI) or 8% of gross receipts, and on cannabis manufacturing, distribution and dispensary businesses up to 8% of gross receipts, to maintain general funds for City services and to address cannabis industry impacts, with all funds subject to audits and staying local, generating undetermined revenue until repealed?",2,Business Tax,112,Revenues: Tax Creation/Incr./Contin.,25632,7535,33167,0.7728163536044864,M,1,Pass,0,201700087,25632,7535,33167,0.7728163536044864,1,Pass,1,110
201700088,2017,49,2,SONOMA,2017-11-07,Cotati,0,M,G,"Shall an ordinance be adopted authorizing a City of Cotati cannabis business tax on cannabis cultivation businesses up to $25 per square foot of cultivation area (annually adjusted by CPI) or 8% of gross receipts, and on cannabis manufacturing, distribution and dispensary businesses up to 8% of gross receipts, to maintain local City services and address cannabis industry impacts with all funds subject to annual audits, generating approximately $300,000 in revenue per year until repealed?",2,Business Tax,112,Revenues: Tax Creation/Incr./Contin.,972,262,1234,0.7876823338735819,M,1,Pass,0,201700088,972,262,1234,0.7876823338735819,1,Pass,1,110
201700089,2017,49,2,SONOMA,2017-11-07,Windsor,0,M,H,"Shall the Town of Windsor adopt a resolution extending the Urban Growth Boundary (""UGB"") to December 31, 2040, revising the boundaries of the UGB to include approximately 22.5 additional acres for future business growth known as Assessor's Parcel Numbers 164-150-010, 164-150-009, and 164-150-054, and amending certain policies regarding implementation of the UGB?",70,Ordinance,21,Land Use: Growth Cap/Boundary,3337,1098,4435,0.752423900789177,M,1,Pass,0,201700089,3337,1098,4435,0.752423900789177,1,Pass,70,20
201700090,2017,50,2,STANISLAUS,2017-11-07,Modesto,0,M,T,"Shall the City of Modesto adopt an ordinance establishing a cannabis business tax on all cannabis businesses within the City, up to 10% of gross receipts of each business, potentially generating approximately one million dollars or more in revenues annually for general City services, including neighborhood safety, maintaining parks and recreation, and job creation, with all revenues remaining local, and which continues until repealed by the City Council or the voters?",2,Business Tax,112,Revenues: Tax Creation/Incr./Contin.,19832,4214,24046,0.8247525575979373,M,1,Pass,0,201700090,19832,4214,24046,0.8247525575979373,1,Pass,1,110
201700091,2017,54,2,TULARE,2017-06-06,Lindsay,0,M,O,"To help prevent the loss of vital public safety services, to maintain essential infrastructure, and to protect other general services, shall the City of Lindsay enact a general-purpose, one-percent sales tax, expected to generate $908,000 annually, with annual independent audits?",4,Sales Tax,112,Revenues: Tax Creation/Incr./Contin.,397,184,581,0.6833046471600689,M,1,Pass,0,201700091,397,184,581,0.6833046471600689,1,Pass,1,110
201700092,2017,54,2,TULARE,2017-11-07,Farmersville,0,M,P,"For local revenue to improve the quality of life and essential general City services for Farmersville residents including police, 911 emergency medical response, fire department services, gang prevention programs, recreational facilities, park maintenance and improvements, street maintenance and repairs and other general services, shall Ordinance No. 483, imposing a one-half percent general transactions and use tax, be adopted? Estimated revenues of $280,000 annually, indefinitely.",4,Sales Tax,112,Revenues: Tax Creation/Incr./Contin.,225,147,372,0.6048387096774194,M,1,Pass,0,201700092,225,147,372,0.6048387096774194,1,Pass,1,110
201700093,2017,54,2,TULARE,2017-11-07,Farmersville,0,M,Q,"Shall Ordinance No. 484 be adopted authorizing a commercial cannabis business tax in the City of Farmersville on commercial cannabis businesses up to $25 per square foot (annually adjusted by CPI) or 10% of gross receipts, to maintain essential public safety and general City services including, but not limited to, police, drug addiction and gang prevention, park maintenance, street maintenance for Farmersville residents, generating undetermined revenue, potentially $500,000 to $3.5 million annually, until repealed?",2,Business Tax,112,Revenues: Tax Creation/Incr./Contin.,242,128,370,0.654054054054054,M,1,Pass,0,201700093,242,128,370,0.654054054054054,1,Pass,1,110
201700094,2017,54,2,TULARE,2017-11-07,Woodlake,0,M,R,"To provide local funding to improve quality of life; parks and recreation programs; neighborhood police patrols; gang prevention programs; street maintenance; lighting, landscaping, and trails; and other essential services, shall City of Woodlake Ordinance No. 609, imposing a one percent general transactions and use tax with independent audits and citizens’ oversight, be adopted? Revenues are estimated at approximately $430,000 annually, indefinitely.",4,Sales Tax,112,Revenues: Tax Creation/Incr./Contin.,293,163,456,0.6425438596491229,M,1,Pass,0,201700094,293,163,456,0.6425438596491229,1,Pass,1,110
201700095,2017,54,2,TULARE,2017-11-07,Woodlake,0,M,S,"Voters in California voted to impose state taxes on licensed cannabis businesses. Shall Ordinance No. 610 be enacted, imposing a local general tax on cannabis businesses at a rate not exceeding $25 per square foot (annually adjusted by CPI) or 10% of gross receipts, to maintain essential public safety and general City services for Woodlake residents; generating undetermined revenue until repealed?",2,Business Tax,112,Revenues: Tax Creation/Incr./Contin.,308,146,454,0.6784140969162996,M,1,Pass,0,201700095,308,146,454,0.6784140969162996,1,Pass,1,110
201700096,2017,1,3,ALAMEDA,2017-05-02,Hayward Unified,0,M,A,"To protect critical education programs, with funds that cannot be taken by the State, including math, reading, writing, and hands-on science classes and labs; restore and maintain music and art programs; enhancing library services, technology and college preparation programs; and attracting and retaining qualified teachers; shall Hayward Unified School District renew its expiring voter approved education tax at $88 per parcel annually, for 12 years, with senior exemptions, independent citizens' oversight and all money used for classrooms?",3,Property Tax,10,Education,9101,3778,12879,0.7066542433418743,T,1,PassT,0,201700096,9101,3778,12879,0.7066542433418743,1,PassT,1,10
201700097,2017,1,3,ALAMEDA,2017-08-29,San Leandro Unified,0,M,B,"To attract and retain highly qualified teachers, and to continue programs to improve core education in our local schools, particularly in math, science, technology and the arts, support manageable class sizes, and school libraries, shall the San Leandro Unified School District renew its existing parcel tax for 14 years at a rate of $78 per year, with an exemption for seniors, independent fiscal oversight, no money for administration, and all money benefiting San Leandro students?",3,Property Tax,10,Education,5472,3085,8557,0.6394764520275797,T,2,FailT,0,201700097,5472,3085,8557,0.6394764520275797,2,FailT,1,10
201700098,2017,15,3,KERN,2017-07-25,McFarland Unified,0,M,D,"To build, renovate or expand new or existing school facilities and provide 21st century learning environments, reduce student overcrowding, increase classroom technology infrastructure, and upgrade vocational education facilities to prepare students for college and high-paying jobs after graduation, shall the McFarland Unified School District be authorized to issue up to $20 million in bonds at legal interest rates, with an independent Oversight Committee, annual audits, and no money for administrator salaries?",11,GO Bond,10,Education,238,375,613,0.38825448613376834,T,2,FailT,0,201700098,238,375,613,0.38825448613376834,2,FailT,10,10
201700099,2017,19,3,LOS ANGELES,2017-03-07,Arcadia Unified,0,M,A,"To keep Arcadia schools among the best in California by renewing approximately $4.3 million in annual local funding the state cannot take away, shall Arcadia Unified School District continue attracting/retaining quality teachers; keeping schools safe/clean; protecting quality math, science, technology, reading, writing, art and music programs by extending the expiring school parcel tax at $288 per parcel annually for 18 years, requiring independent oversight/audits, senior exemptions, and all funds used locally to maintain quality education?",3,Property Tax,10,Education,4874,2333,7207,0.6762869432496185,T,1,PassT,0,201700099,4874,2333,7207,0.6762869432496185,1,PassT,1,10
201700100,2017,19,3,LOS ANGELES,2017-11-07,Glendora Unified,0,M,GG,"To upgrade and modernize classrooms, science labs, career training facilities, computer systems, and instructional technology to support high quality instruction/student achievement in science, technology, engineering, math/skilled trades, acquire, construct, and repair classrooms, facilities, sites/equipment, repair aging plumbing, electrical, heating/ventilation systems, improve student safety and campus security systems, shall Glendora Unified School District issue $98,000,000 in bonds at legal interest rates, with independent citizen oversight, no money for administrator salaries and all money staying local?",11,GO Bond,10,Education,2461,2763,5224,0.4710949464012251,F,2,FailF,0,201700100,2461,2763,5224,0.4710949464012251,2,FailF,10,10
201700101,2017,19,3,LOS ANGELES,2017-11-07,La Cañada Unified,0,M,LCF,"To repair and modernize classroom and school facilities, including fixing deteriorating roofs, plumbing and electrical systems, improve student safety and campus security systems, upgrade/expand classrooms, science labs, career-training facilities and instructional technology to support advanced programs in math, science, engineering, technology and the arts, construct, acquire, repair classrooms, sites, facilities and equipment, shall La Canada Unified School District issue $149,000,000 in bonds at legal rates, with citizen oversight, all money staying local and without increasing current tax rates?",11,GO Bond,10,Education,2900,1185,4085,0.7099143206854345,F,1,PassF,0,201700101,2900,1185,4085,0.7099143206854345,1,PassF,10,10
201700102,2017,21,3,MARIN,2017-11-07,Lagunitas Elemantary,0,M,A,"Shall the Lagunitas School District maintain vital educational programs including basic educational programs, enrichment and support services for students, by levying a $535.00 assessment per assessor’s parcel per year, with 6.5% yearly cost-of-living adjustment for 8 years, beginning July 1, 2018, exempting any single parcel used as a principal place of residence by any owner 65 years of age before February 1st of that year?",3,Property Tax,10,Education,1072,422,1494,0.7175368139223561,T,1,PassT,0,201700102,1072,422,1494,0.7175368139223561,1,PassT,1,10
201700103,2017,27,3,MONTEREY,2017-11-07,North Monterey County Unified,0,M,E,"To reopen and rebuild Moss Landing Middle School, constructing new campus classrooms, buildings and library, replacing infrastructure, providing technology for 21st century learning, hereby allowing the current middle school to reconvert to an elementary school relieving severe overcrowding at elementary schools, shall North Monterey County Unified School District be authorized to issue $36,000,000 in bonds at interest rates within the legal limit with no funds for administrator salaries and an appointed Independent Oversight Committee to monitor all bond expenditures?",11,GO Bond,10,Education,1390,1790,3180,0.4371069182389937,F,2,FailF,0,201700103,1390,1790,3180,0.4371069182389937,2,FailF,10,10
201700104,2017,27,3,MONTEREY,2017-11-07,North Monterey County Unified,0,M,F,"To upgrade schools by replacing old portables with new classrooms, science labs, athletic facilities at reopened middle school, relieving overcrowding, reducing traffic congestion, increasing safety, repairing or replacing inefficient heating, plumbing, electrical systems; replacing, constructing and renovating schools, shall the North Monterey County Unified School District be authorized to issue $40,000,000 in bonds at interest rates within the legal limit with no funds for administrator salaries and an appointed Independent Oversight Committee to monitor all bond expenditures?",11,GO Bond,10,Education,1432,1744,3176,0.4508816120906801,F,2,FailF,0,201700104,1432,1744,3176,0.4508816120906801,2,FailF,10,10
201700105,2017,41,3,SAN MATEO,2017-03-07,Menlo Park City Elementary,0,M,X,"To protect outstanding public schools; retain high-quality teachers, excellent programs, and reasonable class size; avoid teacher layoffs; and sustain property values, shall the Menlo Park City School District replace its expiring parcel tax at the new rate of $360 expiring after seven years, adjusted annually for inflation, raising $2.83 million annually to be spent only on teachers and essential educational programs at Encinal, Laurel, Oak Knoll, and Hillview schools with independent oversight, annual audit, and senior exemption?",3,Property Tax,10,Education,5858,1548,7406,0.7909802862543883,T,1,PassT,0,201700105,5858,1548,7406,0.7909802862543883,1,PassT,1,10
201700106,2017,41,3,SAN MATEO,2017-03-28,San Mateo-Foster City Elementary,0,M,Y,"To protect local schools from substantial program cuts by renewing local funding that cannot be taken by the State, protect math/science/reading/writing programs, attract/retain qualified teachers/educational staff, keep school libraries open and support art/drama/music programs, shall San Mateo-Foster City Elementary School District renew without increasing, its expiring voter approved education tax at $209.92 per parcel annually for 9 years, with CPI adjustments, senior exemptions, annual audits, and citizens’ oversight?",3,Property Tax,10,Education,13039,6951,19990,0.6522761380690345,T,2,FailT,0,201700106,13039,6951,19990,0.6522761380690345,2,FailT,1,10
201700107,2017,41,3,SAN MATEO,2017-04-04,Woodside Elementary,0,M,Z,"To maintain and enhance academic excellence at Woodside School through emphasis on quality instruction, especially in math, science, reading and writing, attracting/ retaining outstanding teachers/ maintaining small class sizes, shall the Woodside Elementary School District extend its existing annual school tax without increasing the current rate of $290.00 per parcel each year for eight years, adjusted annually, with independent citizens’ oversight, an exemption for those 65 years and older, and all funds spent only in Woodside School?",3,Property Tax,10,Education,844,313,1157,0.7294727744165946,T,1,PassT,0,201700107,844,313,1157,0.7294727744165946,1,PassT,1,10
201700108,2017,43,3,SANTA CLARA,2017-03-07,Lakeside Joint Elementary,0,M,A,"To preserve high quality academic programs for elementary and middle school students, attract/retain high quality teachers, keep instructional programs up to date, and provide a safe, well maintained learning environment in our mountain community, shall the Lakeside Joint School District levy a temporary 8-year education parcel tax of $647, with citizens’ oversight, exemptions available for senior citizens, no funds for administrators' salaries, every dollar spent on Lakeside students and cannot be taken away by the State?",3,Property Tax,10,Education,182,62,244,0.7459016393442623,T,1,PassT,1,201700108,542,214,756,0.716931216931217,1,PassT,1,10
201700111,2017,44,3,SANTA CRUZ,2017-03-07,Lakeside Joint Elementary,0,M,A,"To preserve high quality academic programs for elementary and middle school students, attract/retain high quality teachers, keep instructional programs up to date, and provide a safe, well maintained learning environment in our mountain community, shall the Lakeside Joint School District levy a temporary 8-year education parcel tax of $647, with citizens’ oversight, exemptions available for senior citizens, no funds for administrators' salaries, every dollar spent on Lakeside students and cannot be taken away by the State?",3,Property Tax,10,Education,360,152,512,0.703125,T,1,PassT,1,201700108,542,214,756,0.716931216931217,1,PassT,1,10
201700109,2017,43,3,SANTA CLARA,2017-05-02,Los Gatos Union Elementary,0,M,A,"To maintain outstanding academic programs including: science, engineering, math, reading, writing, music and arts with local funding that cannot be taken by the State; attract and retain highly qualified teachers; provide safe and modern facilities for student success; shall Los Gatos Union School District authorize an annual $290 school parcel tax for 8 years, raising approximately $2,800,000 annually, with independent oversight, no funds for administrators, an exemption available for seniors and all funds benefiting local elementary and middle schools?",3,Property Tax,10,Education,4877,2553,7430,0.6563930013458951,T,2,FailT,0,201700109,4877,2553,7430,0.6563930013458951,2,FailT,1,10
201700110,2017,43,3,SANTA CLARA,2017-05-02,Mountain View Whisman Elementary,0,M,B,"To continue local school funding, support struggling students, offer competitive compensation to attract and retain the best teachers; maintain small class sizes; enhance hands-on science, technology, math and engineering programs; maintain outstanding music and art education; and support core academics, shall Mountain View Whisman School District levy a tax of $191 per parcel – an increase of $64 for most homeowners – for 8 years, generating $2,800,000 annually, with independent oversight, exemptions for seniors and funds staying local?",3,Property Tax,10,Education,7409,2886,10295,0.719669742593492,T,1,PassT,0,201700110,7409,2886,10295,0.719669742593492,1,PassT,1,10
201700112,2017,49,3,SONOMA,2017-11-07,Wilmar Union Elementary,0,M,F,"To provide local funding which the State cannot take away, keep class sizes small, protect academic excellence, vocal and instrumental music, arts, maintain counseling services, provide current technology, and keep our library open, with no funds spent on administrators' salaries, and provide a senior citizen exemption, shall Wilmar Union School District (Wilson School) be authorized to levy $65 per parcel annually for eight (8) years ($70,980 annual funds raised)?",3,Property Tax,10,Education,551,305,856,0.6436915887850467,T,2,FailT,0,201700111,551,305,856,0.6436915887850467,2,FailT,1,10
201700113,2017,53,3,TRINITY,2017-11-07,Mountain Valley Unified,0,M,J,"To improve the quality of education by modernizing 50 to 60 year-old classrooms, restrooms, and school facilities; replace leaky roofs; make health and safety improvements including major mold removal, lead and asbestos abatement; increase student access to computers/technology/ to meet 21st century educational standards; and replace deteriorating plumbing, sewer, electrical heating, and cooling systems. Mountain Valley Unified School District will issue $5,950,000 of bonds at legal interest rates, have an independent citizens’ oversight committee and have NO money for administrative or teachers salaries.",11,GO Bond,10,Education,457,244,701,0.651925820256776,F,1,PassF,0,201700112,457,244,701,0.651925820256776,1,PassF,10,10
